1111111111111111111111111111111111111111111111111111111111111111111111111111111111111111111111111111
1111100011000000001000000000011110000000000000000000000111100000000000011111000000000000000001111001
1111111011011111111111010000000001111110110100111111000000001111111110000000011111111110111111111001
1110000011000000000111011011111111111110110100111100000001011111111111110000000000000000000001111001
1100000000000000000111011011111000001110110101101101000111010111111111110111111000000011110100000001
1111111001111101110111011011100001111110111101100101000111010111111000010111111011110011110110110001
1000001000000000000111011011101101101110111101100001010110010111100000010111110011111011100110110001
1011111010110111111110011011001101101111000001101011010110010111111110010111110010111110110000110001
1011111010110110111110011011101101100001011101101011000000000110111110010111110010000000000000010001
1011111011110110110110000011101101100001011101101110011000000000000000000111110010011111100001110001
1011000011111110100000000000000101100101010100001000011111100000001110111111110000000000000000000001
1101000000000000101110111100000001101101000101111000011110001011100000000000000110101111100001111001
1101000001111000101010000110011111100001100001111000011110111010000000000011110110101111100001111111
1001111101110000100010011110111111100001111100000000000000111010000111111011110000001111100001111111
1000000001110110101010011000000011100101000000000000000000111010000000000011110001111011100001111111
1000001011110110101010000000111001001100101100011101010110001010100111111111110000001011100001111111
1010011011110110101011111010110001000000101100101101010010001010100000000001000001101000000011111111
1001011011110110100011111000111001011001101100001101010010000010100000000111011000101000000000000001
1001011011110000000000111000111001011001111100101101010010110010101111110111011111101011110111111101
1000000000010111000000111100111001000000000000101101110011110110100000110111011111101011110111111101
1001110000010000001111111100111000000000000000101101110011110110001111110111011111101011110111111111
1000000011001111101111111101111000000000000000000101110111110110101011110111011111101011110001111111
1011111111001111101111111101111001111100011110101101110000001110101000000000011110000011110111111111
1000001111001111111111111101111001111100000110101101110011111110001001111111110000111111110111110001
1011101110001110000010111101111011111100110110101101110001111110011001111111111110000000000000000101
1000100000001100000010000000000001111100000000001101110111110110000001111111111111111111111110110001
1011101100000000111010100011010001101100010000001101110111110110000001100000111111111111111110110001
1000000000011110111010101011110001101000010111100001110110000000110000000000111111111110000000000001
1000010010011110001010101011100111101010010111101111010110000000110011111111100000000001111110011101
1000000010011110111010000000000000001011010011111111010110111000010011111111101110000000000000011011
1001101010011110100010100000000111111011010011111111010110111011110011000000000000001111111100011011
1011111011000000101110101111111111111011010011111111000100111011110011101101111111001111111110010011
1011111011111111101110101000011110000000010000111000010100111011111000000001111111001100000000010011
1010000000000000101110101011010000000000000010000111010000111000000000000000000000000001111110010001
1010111000000000101110101001010000000000000010000000000000000010000000100000000000000000001110010001
1010001111111110101000101000010111111011100110111101111100010011010110111111101111010111111110100001
1010100000001110100000000011000111111011100110111101111110011011111110011100001111111111111110100001
1010111111111110111111111111001111100010000110111111000000000011111111011111100000000011000000100001
1000000000000000110000000000000000000000000000000000000000000001100000000000000000000000000000000001
1111111111111111111111111111111111111111111111111111111111111111111111111111111111111111111111111111
