1111111111111111111111111111111111111111111111111111111111111111111111111111111111111111111111111111
1000000000000000000000000000001111100000000000000000000000000000000000111111110000000000000001111101
1011111100111111100000000000000000111111000000011110100111111011111111111111111101111111111101111101
1011111100000111111101100000011111111111111110011110100000001111101111111111111101111111110101100101
1011111100111111111101110100111111111111111110011110101000111111101111111111111101111111110111100111
1011111110111111111100000101110111111111111111000110100000000111101111111000000000000000010000000111
1011111110111111111111110101110111111111111111011111111100000000001111111011011110000000000111100111
1011111111111111111111110101110011111111111110011111111101110000000000000011011110111110000000000111
1000011100000000000000000101000000000000000010000000000000000001111111000011011110111110000000010111
1011111101011011111111010100000000001111111010000000000000000000100011011111010110000000111111110011
1000000001011011111111010110111011100000001010001111110000001110101011011111010110100000111111110001
1101111011011011111111110110111000000111000010001101110110000110101011000000010111111110000101111101
1101111011111011111111110000011011111111000000000001110000010111100011011111110100000110111100001101
1101111000001111111111111010000000000001011101111101111111010111110011010000000101111110000000111101
1100000000011100000000001011111111111101011001011100010111010000000000000000000000001111111111110001
1101110000011101111111111011111111111101000000011101110111000000001011011111111111111111111111110101
1101100000011100000000000011111111110000000101011101110111000001111011010000000001111111000000010101
1100000001111111111011111000000000010111110101000001110111011100000000000111111111111111111111010101
1100001111111111111011111011111111010000000101111100000000010101100001100111111111111000000000010101
1100000000000000100000111111111011111110000000001000001111110101110001110111111111111110110111110101
1100000011111100111010111011111011111110000111001010001111110101110100100111111111111110110111110101
1101111011111100011010111011111011111110100111001011101000000000000100100111111111111110110000000001
1101111000000001011010101011111011111110100101001011101000000000010100100111111000000000000000000001
1101111110111111011010101010000010000000100101001011101111111111011100000000000000011111111111011101
1101111110000111011010000011101010111110100101011011100000000001011111111111111100000000001111011101
1101111110111101011000101111100010110000101101111011001111111111011110000000000000000010111111011101
1111111110111101011011100000000010111110100001111010000000111111011111011111111101111110111111111101
1011111110111101011111101111111110111110100111111010000000011111011111011111000000000000000000000001
1010111110111101111101101111111110111000100111111011111111011111011111011000111111111111101000101111
1000111110111100011101101111111111111010100111111000000011011111011111011010111111111111101000101111
1110111000111111011101101111111110000010100000011111111011011111011111011010100111101111101000111101
1110111000111111000001001110000110111110100000000110000011000000011111111010100111101111101000000001
1110111000111111000011001110110000011000000001110100000000000001001111111010000000101111100000110001
1110111000000000000010001110111100011111111001000111111111111101001111101010000111101111111110110111
1010001111111111111110001110111100011111111001111111000000011101001111101000000111101111110000110111
1011100000111111111000000000111100011111100001000000000111101101001111101011000111101111111111110111
1011101111111111111111000011111100011111101001001111111111001100000000000011100111101111111111110111
1111101111111111111111111011111100011111101011100111111011000000001111111111101111001111111111111111
1111100000111111111111111000000000000000000000000000000000001111111100000000000000000000000000001111
1111111111111111111111111111111111111111111111111111111111111111111111111111111111111111111111111111
