1111111111111111111111111111111111111111111111111111111111111111111111111111111111111111111111111111
1000000000000000110000100000000000000000000000000000000010000000010000000000000000000000111100000001
1010011111101100110110111111001111111110111000001011010000010000011110111111110110111110000101110101
1010000000001100110010111111000000111110000000001111010000011101011110111111110000111110010111100101
1010111110111100000010000000000111111110110111001111011100011001011110110000110110000000110111110101
1010100000111100100011101111110000000110110111001111000000010001000000000110110100010000110111110101
1000011110111100100011101111000000000010000111001111111111010001011111111110110100011110110111110101
1010000000000000100011101111011111111010110111001111111111000001001111111100100100011110110111110101
1011111111111110100011101111000000000010110111001111111111010001011111111100111100000010110111110101
1000000010000000101001101111111100000000110100001111111111011100011111111100000100111010111111110101
1000001110111111101001000000000000000000000101101111111000000000011111111101010100000010000000000101
1000000000111100000001111010000000000011011101101111111111111111111111111101110001111010111010000001
1011111011111101111000011010110000000000001101101111111111111000000000000001111100011010000011011001
1011110000000001111010011000000011111111011000000000001100000000000000000001111100011010100011011001
1011100001111100000010011011000001110000011011111111111100000011111111111000001100000010111011111001
1001101101101100100000011001111101111000011000000000111111111001000000000000000001111110111010000001
1010001101101100111011011101011101111111000011111110111100000000000000011111111101111110111010110101
1010101111101000111010011101011100000000000011111110111111111110111111011100000001111010111010111101
1010101111101100000011011101011100000000111111111110111111111111000001000001111111111010001000111101
1010001111101101011011011100011100011010111111111110111111110100000001011101111111111011011010111101
1000101101101100011010011100011100011010000000000000000011110100011100001100111111111011011010111001
1010101001101111011010011100011100011011101111001101110000000000011111001100111111110000011010111011
1010100000101111011000011100011100011001111000001100110000000000000000000100000000000000000011111011
1010111000101111011000011100001101011001100000001110110100010100001110000000011111101111101011000011
1010111110100110011111111100011101011001111101101110110100110100111000000000011111101111101011010001
1010111110000001011000000000011101011001111110111110110100110100111111101111000011100000000000010101
1010000011111111000000000000000101000000000000111111110101110100111111101111000000000111100111000101
1001010000001111111110000000000000001111101100111111110001100000110000001111111111011111110000000101
1010010110001111111110111111111110101000101100111011110000101000110111101111111111011111110100010101
1010010111101111111110111111111000101011101100111011110101101000110111101111011110011111110111110101
1010010111101111111000000111111111111000100000011011100100000000110111101111011110000000000111110101
1010000111000000000000100011111110000000000000111000001101111010011000000000011100111111110111110001
1010111111011111111100101011110000000011000000011111101101111010011000011111000000001111111111110001
1010000000010000000000100011111011110111110001111111101100000000011000000000000000000111111111110001
1010101000000100101000001111111111110111111101111111101100110000000011111110111100000000000011010001
1110101111110100001001001111111111110111111101111101101110110111110111111110111111110000001100000001
1000100000110100111000000000000001110110001101111101101110000111100000111110011111110011111110011001
1011101111110100111111111111111111110110111101111100101111111111111110111111011111110000000000000001
1000011110000000000000000000000000000000000000000000000001100000000000000000000000000000000000000101
1111111111111111111111111111111111111111111111111111111111111111111111111111111111111111111111111111
