1111111111111111111111111111111111111111111111111111111111111111111111111111111111111111111111111111
1111111111111000000000000000000000000111000010000000111100000000001100000000011111000000000000000101
1111111111111111110000000010111001111111111000111111111110000010101111110000000000000000000111011101
1111111100000000000001111110111000111111100011111111111110111010101110001111111111111111110111011101
1000000001111011000000000111111000100000001011111111000000100010101111101011111111100000000111011101
1011111101111000001111110110111000101000001011111111010100111010101111000000001111111111110111000001
1011110001111000000000110000111000101011101011111111000100111010111111011111101111111111110000011101
1011110101111010110110111100111000101011101011000000000000111010000000000000001000111111110111011001
1000110101111010110110001100111100001011101011111111111000000111111000000111101011111110000000000001
1011110101111010110111111100111101101000101010111110000011111111000000010111101011111110011111111001
1001111101111000010000000000111001101110101010111100000000001111111111010111100000000000011111111001
1011111101101011111111000000000001101110101010111100111111101110101111010111100111011100011110111001
1011111101101011111111111100000011101110101010111100000001101110101000010110000111111111000010111001
1011111101101000000000000001110111101110101110111111111101101110101000110110100000000000011110111001
1011111100000011111100001001110111101110111110000000000001101110101110011110100111001101111110111001
1011111101111111111111101001110111101110000000111111111100000000001110111110100111011101111110000001
1011111100111111111111001101110111101111111011110000001111110001101110111110100111110100011110111101
1011111100000000011111101101110111101111111011110000000000000001101110000000000111110101011110111101
1011111111011111111111100111110000000111111000000000010111101001101111011111000111110101011110111001
1011111111011111111111101111111010110111111001101111110111101011101011011010000111110001111110111101
1011111111011111111101101111111010100111110001101110110111111011001011111011110111110001111110100001
1011110111011110000000001111111010000111111111101110110111111000001011111001110000000001111110111101
1001110111100010000000111111111010100000000111111110110000011011000000111010000000000001111110111101
1001110111101010111000000000000010100111110111111110111011011011001110111000000000000001111110001101
1001110000001010000000000000111111100111110000111110111000001001001110111111111101100111111110111101
1011111111110010000000001111111011100111111101111110111100011101001110111111111101100111100000111101
1011111100000010001111111111111000000000000000111110111100011101001110000000000001100000110111111101
1011111111111000101111000000000011110111111100111110111100111101000000000001101110000110000000111101
1011111111111000001111111111111011110000000100000110111100111001101111111101100110110111100000001101
1011111111111110101100011111111001110000000011111110111100100011100110000101100110110111101111111101
1011101111000000101101011011111001110111101000000000011100100011100000010111100110000111101111111101
1011101111011100100001001011111001110100000010011000001110111111101111110111100111111111101000001101
1011101111011100100011101011111001110001111110011111001100111111101111110111110111111111101111101101
1011100000011000111000001011111101110001110110011011000000000000001111110111110111111111101111100001
1011111111111000111011101011111101110000000110011000000001011111111111110111110111110000001111100001
1011111111111000111011111011000001110000100110111000000001011111111111110111110111110111101111000001
1011111111110000111000111011011101111111100110111011000000000000011111000000110111110111001111111101
1000000000000100100010000011011100111111000000000011110000001111111111011111110100000100000000000001
1000000000000000000000000000000000001111000000000000000000000000000000000000000111111111100000000001
1111111111111111111111111111111111111111111111111111111111111111111111111111111111111111111111111111
