1111111111111111111111111111111111111111111111111111111111111111111111111111111111111111111111111111
1111011001011110100111001101100001010110000001111110111111111000000000001100110000000000100111111111
1111011001011110000111001111101110000000001111111110000000000001111111111100000000000000101111111111
1111011001011110000111001111101110001111100000000000011111000001110000000000111111111111100000000001
1111011001000000000000001111100110000000000000011111000000000001111111111100011111111000000100111111
1111011000001111001111011111101110000111111111111111000001111011111111111101111111111110100100111111
1111011001101111001111011111101010100111111111111000001111111000000111111101011111111110100100111111
1001111011101111001111011111101010111011111111111001101111111011101111011101011111111110100100111111
1000111111000000001100011111111010000000000111111000000000000011101111011101011000011110101100111111
1111111111001111001110111111111010011110100111111111111111010011101111011100000000011111111000111111
1110000000001111001110110000000000010000111111010000111111000011101111011101011100011111110010111111
1000111111111111001111110101111111110000111111011010111111011011101111011101011100000000010010110001
1100111111110000001111010101110111110011111111011010110000111011101111011101011100111111000010111101
1100111111111101101111010101110011110000000111011110000000111000000000000001000000000000000110111101
1100111111111101101100000101110011111011101110000000000100000001111111111111011111100000010111000001
1100111111111101101101111100000011111011101100010000000111110000000011110000011111100111110000011111
1000111110100001100001111100000000000011101110010111111110000111111111111111000001100111111111011111
1000110110111111100011110100000000000011101110010111111111010000000111111111111100000000000011011111
1011110110000000000010110100111111111011101000010111111100010010000000000011111000001101110011011111
1111000111100011110000000111111110100000000010010111111111010010100000000010111110111101110000000001
1110010111111111110011110000000000000001111110000111100000000110101100000000000000111101110000000001
1110000110000000000011111111111110101011111110110000000111100110101100000001111110011101110001111001
1110010111001111110011111111111110111011100000110110000111110110101101111101111110111111110100000011
1110000111001111110011111111111110001011111110110011110000000110100001111101111000001111110110011011
1110011011000011110011111111111111111011100010110111000001011110001001111111111101011111000000011011
1111111000010000000000000000110100000011111010110000001100011110000001111111000001000000000000000011
1111111001011111110000011010110110111010000000110011001000110100001100111011000101011100000000011011
1111111001011000000011100010100000000011111011110011001000110101101100111000011100011100011111011001
1100001011011111110000000000001011111111100011111011001011110101100100001000011100000100011111011001
1101111010001111110111011111101011111111001111111011001011110101101100101011111100110100111101011001
1100001010001011110111011111101000000000000011111000011011110101101100001000000000110000011101011001
1101100000001011110000000000000011011011111110000000011011110101100000000000000001111110010000011011
1101100111001011110000000001011011011010000000000001011011000000000010000000000101111110010111011011
1101100111000000000100000011011011011011011110111111011011111101100010111110000001111110010000010011
1100000101010011100001111110000011011011011110111111011011111100000000001111111111110000010111010011
1111110101011010000000000010111111011000000000011110011011111100000000000000011111110000110110000011
1111110101011010111111011111111000011001111110111111000001111100111111000000000000000111111111111111
1111100100011010111111111111011111111000111110101111011111111100011111110111111101110000000000000111
1111101001111010111111111111011111111111111110101111000000000000001111101111111100110000000111111111
1111111111111111111111111111111111111111111111111111111111111111111111111111111111111111111111111111
