111111111111111111111111111111111111111111111111111111111111
111100000000000000000000011111111000011110000011111110000011
111101111000001111110000000000000011000001111000000000000011
100001100000111110000000001110000011111111111000000000011011
100000101111111110001111111111110011000111111011111111111011
10111110111100D00000101111111111000000000011001111100000D011
101111101111D11111001011100000000000111000110000010000001011
1011110011110000010010111000000000000011100000110111111D1D11
1011110000D0000000001011111110000001101110000101000011101011
100011111111100000000011111000111100000000000000000001101011
100000000000110000000011111111100000000000000000000101101011
100000000000110111100000111111000000000000000000000100D01011
1111111111D1110111011110111111101E11110000000000000100101011
11111111110111000000111011111110111111D111111111111100000011
110100000001100011111110011111101111100111111111111101110011
110111011100000010111110111111101101100111110000000001110011
100111011110000000111100000000000000000000011111111101110011
101100001111110000000000011111011111111110011111111001110011
101100000000001010000111001111011111111110011111111100110011
101111100000000000000011011111000000111110001000000000110011
10000000010000001011111100000D000000000000001111111110110011
101110111101111110000011001101101011101101001111111110111011
10111011110111111000000000000000100D000000001100000000001011
101110000101011110011110000000000011101010000111111110111011
1000000001010111100111101000000111111D1010000111111110111011
100010000100000000011110000001D11111101010000101111110111011
111010111101111110011110000101011110101010000101111100001011
111010110001101110011110000101011000001010000101111101100011
111010000001100000000000000000011111101000000000110001101111
111111111111111111111111111111111111111111111111111111111111
