111111111111111111111111111111111111111111111111111111111111
101111111111111000001001111100001111111111111111111111111111
10D110000000111011110000001001100111111100000111111110000011
100010111111111011110111111001100111111101111111111110111111
111000000000000000000000000000000111100000111111111100111111
111111111111111101111100000001000111111110111110000000000011
111111111111000000000000000000000001100000111110111000000001
1000001D1111111111111111111111110000001110000000100000111101
100111111111111111111111111111111111100110111111000110111101
110111011000001111111111111011111111100000000000000110111101
110111011111000000000111111011100000001111111111000000011101
11011100000D011110100111111011111111111111111111011111011101
110111001000000000110111110000000000000000111111001111011101
100000000000111110000101111111111001110000000111001111010001
101100111100001111111100000000111001111111110110001111010111
101100000000001111111101111000001001111111110111000000010001
101101111000011111111100000000001000000000000111000000000001
101101111111011111111111111111100001111111111111010000011101
111101111111011111111111110000001101111111111101011111011101
111101110111011111111111110000100000000111111101011111011101
11000111011101111111D111111110111111110110111101011100011101
111111110111010000000000000110100000000110111101011100000101
111111110111010000011111111110101101110110111101011111011101
111111110111010000000001000000101101110110111101011111000001
111111110111000000000111111110101100110110111101011111111101
100000000000000111111111111110001100110110001101000000000001
101111111100000110000000001010001100110111100001011111111111
100000000000000000000000000000000000000000000000000000010111
100000010000000000000111101111011111111000000000000011100001
111100000011111111110101101111011000001011111110001111111101
111100110111111111110101101111000011111011111111101111101101
111100010001111111110100000000001111111011111111100011101101
11110110000000000111010110110000D0000010E1111100000011101101
100000000110111111110101101100000111111000001111111000000001
111111111110111111110101101100000111110011111111101011111111
111111111110110110000101001101101111111011111111101011111111
111111111110000000110001000001101110111011111110000001111111
111000000000111111111101110101101110111011111111111001000001
111011111111111111111100000001100000111011110000000000000001
111111111111111111111111111111111111111111111111111111111111
