111111111111111111111111111111111111111111111111111111111111
100000000000000000000011100001100000001111111000000000111111
111101111111110111111000000011000000000011111000000000000001
110101111111110001111000111011000000000000111001111111110101
1101D0000000000000000000110011001111111100000001110000000101
110101111111110100000000000010001101111100111001111110000101
100001111111110111111101111000000001110100011001111111110101
111111111111100000000001111111111101110000001000011111110001
111110111111100000000000000111111101111110111001110010100011
111110111111100000011111000100000101111110000000010010101011
111110111111100000111000000111110100000010001000000010101011
111110110111000111111111100001110101101110000001110010000011
100000000111110111111111101101100100100000000001100011110111
101111110111000111110111101101110110100001111001100010000111
100000110111110111000000001100110100101101111001100010110001
110000110011110100011111111100110000000000000000100010110101
111110000011110111011111100000111101011111111110100000110101
111110110011110111011111101000001100011111111110001111110101
111110110000000111D11110101000000000011111111110000000000101
100000010000000111010000101001111000011110000000111111111001
111011010111110111000110100000000000000000001110111111111111
100011010111100111000010011111111011111000000010110000000001
101010000111100111011110111111111011111011111110000000000101
10100000011110011001111D000000000011110010000000011111011101
101111110111100111001110000000011011111011111110111111011101
101000000000000111011110000000011011111010000000111111000101
100E11111111100110011111101111011011111011111110000011011101
100111101111100011000000001111000011100011111111111011011101
100111100000000000011111111111011111111000000000000011000001
100000010111100011010111111101000000000011111110111011001111
101111110111100011010111111101000000011111111110100010001111
101111110111100011010111111100001110011111110000000011001111
101111000111111000010111111110100000000000001000000011111001
101111000000000000010000000010100110000000001011111011111101
101111111111000000000000000110000111111111111011100000001101
101111110111011100111111110110110110000000000011111110100001
101101110111011101111111110110110000000011111000000000000001
101101110111010000011111110110000111111111111011001111111101
100000000000000000001111110000000111111111111011101111111101
111111111111111111111111111111111111111111111111111111111111
