111111111111111111111111111111111111111111111111111111111111
100000001111111100111111111101111111111111111110000000000001
110000000000000100000000000101110111111100000000011111010001
110111111111111101000000110000000000001100000001000000000001
100011111101111101011111011111111111111100000000000111011101
100000000000000000011111000000001101111100000000000000011101
100110111111110000000110000001111101111100111000111111011101
101110111111110000000000000000011100000100000000000111000101
100110111011010011111111110101111101111100111000000000000001
111110111011010011111111100001110100100000001000001111100001
111110000011010011100111111101000010111100001011101111101111
111100011001010011101111111101100010111111101010000011101111
110100011001010000000000000000001010000001100011101010101111
110000000000000000011111111011101011111101101010101000101111
110110111100000000001111111010001011111101101010101010101111
100000000000000000000000000000001011111100000010100010101111
110111111100000001111111111111001010100000000000000000101111
110111111100111100000111111101000000101111100000000000101111
100000001100111101111111111001000000000001101111011100001111
100111101100001101000000000000011100110111101111011111000111
101111101101101100000000000000000001110111101111011111001111
100111101100001101111110000000000000000000000000000000000001
100111101101100001110000000000000011111111111111111111111101
100100000000000000010100111111111011110110111111110000111101
100101111111010111100000D11111100001110110110000000000110001
100101101111000000000010111111100111110110110111110000000001
111100000001011111111000000000100111100000000111111000000001
111101000000001111100000000000000111101110110111100011100001
110001111111101111100000000001110000001110000001111111111101
10110000000110101110100011111D010100001110111111100000000001
1011111101000000E1101000000000000111001110110111101111101001
100111110100111111101110100000000111001110110111101111001001
101111110000000000001110000000111101001000110000001111000001
100111110000011111101110000011111100001011000000000011001101
110100000000011101101110111100000000001011011011000000000001
110000000010000000001110110000001111001011011010000000000001
110011111100111110101110111101111111000000000010111111110001
100000000000000000101100000000000000000111110010111111010001
100000000100111100100000000000000000000000000010000000000001
111111111111111111111111111111111111111111111111111111111111
