111111111111111111111111111111111111111111111111111111111111
111110000000111110000011111111000000111110011111111111111111
111111111110111111110000010000000011111110011000000001010001
111100000000011111110001011111101011111110000000000011000001
111100000000011111111100011111101011111110011101100111011111
111101111110111111111100000001101011111110011101000000011111
111101111110111111111110011111101010000000011101111111011111
111101111110000001000000000000001000000011011100110111011111
111100011110111111111110001111111100001111011110110111000011
111101111110000000001110011000000110001111000000000000000011
111000111110000000011100011011111110111111101100000000011011
111100111100001111100100000011111110001111101110111110000011
1111001111000011111011010000000111101111011011101111E0011011
111100111110000000001100000111011110111101100000000000011011
111100000111111111111100000000011110111101100000000000111001
111100111111111111111100000000011110000000000110111110111101
111100000000000000000000000001000110000000000000001110111101
110000000000111111011111111100000110000111100000001110111101
110111101111010111011111111100000110111111100111000010111001
110111000011010111011111111100111110100000000111111010111001
110111001000010111011110000000111110001111100000001010111001
110000001111110101000000000000000000000000000000011010000001
110011011111110101011111101100111111111110000110000000111111
111011011111110000011100001100111111111110100110110110111111
111000011111110000011111000000000011101110000000110110000001
111011111100000000011111011100000010101111111011100110111101
111011111111111111000011000110111000101100001011100110000001
111011111111111111011000000110111000101111000011100110111111
100011100111111111000000000100111000000000000011100100111111
100000000000000001111111110100000000001100000000000100011111
100000000000100000000000000000000000000000001111000101011111
101111111100101011111111110000111111000000000000000101011001
101111111100000000000000000000011111100000101110010001010001
101111111101111111110111110000011111111110101110000011011101
101111000000000000110111110010000001100000001110111011011101
101111011111110110100101100000000011101111110110111011011101
100011000000000000000101101011111000001110110110000000011001
101111111111111111110100000011111111101110110110101100011001
100000000000000000000000110000000000001110000000000000000001
111111111111111111111111111111111111111111111111111111111111
