111111111111111111111111111111111111111111111111111111111111
100000000110000000000000000000001100000000000111111111011111
101000000D00000001011000001111111101101111001111111000011111
100000111111111110000001111110111100101111101110111111011011
100111111111110111111101111110111100101111101110111111011011
111011011011110111100001111110111100101110101110111000011011
111011011010110111000001111110111100101010100000000000111011
111000011D10110111001101110000000000001010111110000000100011
111011111000000000000001111111000001111000000000000000011011
111000000000111111000000011110110001000011111111S10000011011
111001111011111111111100000010111101110011111111111000000011
11100111000D001111000000000000000000000000000001111011110011
100000000001111111111100000000111000011111110000111011110011
100000000011111111111111111110011011011111111101111011110011
10111111111111111100011111101011101100D000011101111011010011
100000111111111111000111111010111011011111111000011011000011
100000D00000000000000000000000111011011111111000010000000011
101111111000000000000010111110111011011111100000011011000001
101000000001000000011000111100111011000000111001D11010000111
1011111100000111110110000D0000000011011110100001011000000111
101111011001111101011111111111111000000000001011011010000011
10111101000000000100111111110000000001111110101101001D100011
100111010111111111001111110000011100000001101D11011010100011
100111000111111111001111000000011111110100001011001D10000011
100100000101111111000000000000011111110D01000000010011101111
100000000101110000001100111111000011111111011100000000001111
101111100101010110001100111111110011111111010000000000001111
101111100101010110001100111111110000000111011111100111111111
101111100000000110000000111111110111111111011111100001111111
111111111111111111111111111111111111111111111111111111111111
