111111111111111111111111111111111111111111111111111111111111
110000000000000111111111111111111111111111011111111111111011
110111111111111111111111111111111111111101011111111111111011
1101100000000000000D00111110110D0000000000011111111111111011
110110111111111111011111111011111111111111000111111111111011
110000111111111111011111111011110000001111011111111111101011
111100000000001111011100000000000001101111000000D01110001011
111111101111111111000000000000000001101111000110101111101011
1110D0001111111111011111111000000001101111010110101111101011
111111111100000000011111111111111101100000000000101111101011
1111000D0000000000000000001111111101101100001111101111100011
111111011111100000000000001111111101101111101111101110001011
111111011111101111000000000000000100000000000000001110111011
10000D001111101100001111000111110000001100000000000110111011
110111111111101111101111011110000111111100000111111110111011
100111111111101111100000000000000111111101111111000000111011
1100001100000001111001111111001111111111D1111111011110111011
110111110111111111110111100000111111111001111111010000111011
110111110111111111110111111110111101111001111111010110111011
110111110000000000000000000000001101111000111111000S10000011
110111111111111111111111111111111100000001110111110110011111
110111111111111111111111111111111011111001110111110110011111
1101111110000D00D0000000D000000D0000010000000000000110011111
110111110111111111111111111110111111010111000000000110011111
11000111011111000000000111111D111111000000011111100110011111
1111011101010001D1111101111110110111111111001111111110011111
111101110001110101101100000010110111111111001111111110011111
1011011101D1110001101101100000000000000000000111111100001111
100000000000000001100001111111000000000000000000000000001111
111111111111111111111111111111111111111111111111111111111111
