111111111111111111111111111111111111111111111111111111111111
100000000000001111101111111111111111111111111110000000000011
101101110000001111101101111110000000000000000010111101111011
101100000000001111101100000000111111111111000000001100000011
101101111110000000000101111110111111111111001100000000000001
1011000011100000000100011101100000D0000000011100011111110001
101100111110000111111111000100111111111111001101000000111101
101100111111100000000000000100111110001111001100000000101101
101100111111111111111111100100011111101110001111111000101101
101100111110000000001111100000000010000000001111100010101101
100000000011111011101111101111111011110000000D011000101D1101
101100000000000000000000000000011011110011111101100110101101
101100000000000000001000111110011011110011111001101100101101
101100000000001111111100111010011000000011111001100010101101
101101110111111101101100111010000000000000000001111100000001
1011011101111111000000001110100101111D1111111101111100000101
101001110111111101111110111010010111101111111101100000111101
10110111011000D001111110100000010000000011111100D00000111101
101101110000101111111010111111010000000000111111110000011101
1011000001111010D0001010111111011111000011111111111100111001
10110111101110111100001011111001011111000D000000000000111011
101101100011100001110000111110010111111101111100001110111011
101101111D1110010000000000D000000000000000000000000000111011
101100111000000D00000000001111010000000000000000000000111011
101001110001111100000111000000000111100000010000011110000001
101100000001101101111110000000000101100111010110000110011101
10111110000110110D000100000110000100000000000000000000000001
10000100000000111110000011110000000000000000001100011011L111
100000000001100000001111111110000000000001111111000000111111
111111111111111111111111111111111111111111111111111111111111
