111111111111111111111111111111111111111111111111111111111111
100000001100000000011110001100000000000000000000000000111111
101110100000000000000110000000000000000000000100001110111111
1001101011111110111011100011111111111111E1111000000000111111
100000100000111011100000001111111111100001111111111110011111
101011100000111011100111000000011111101110000000000000001111
100011101110000011100000011100000000001110000000000000000001
111011100110111000000111111110000011101110111111100011111101
100001100110111000110000000000000001101110111111111001111101
101111100000000011110011000000011101001110000000000001000101
101100011000000011110111111111011100000111101111111100110001
101111000000000000000111111111010001110111101111100000000001
101111000000000111110111111111010000000000000000000101111001
101011000001111111110111110111010011111111011111100101110001
101010011111111111110111110111000011111111011111000000000001
100010000000000000000111110111100011110000011111000000000001
101110011111111111110111110111100011011110010000000000000001
101110000111111111110111110111100000000000010100000000000001
101110001111101111000011110100000000000010000111111111111101
100000001111100111100011110101111111111000000111111111111101
101000001111101011100000000001000000011000100111100011111101
100011101111101011001111110111000000110000100111111000001101
100000100011101011000001110000001111111000100000000000000001
101111101000000000000000000000000000000000101000100010000001
100011100111100111111111111111111101111110101010000010111101
100000000011101101110000000001111101011110000001100010000101
111100000011100000000110111111100000000010000000000010111001
111001000000111111110000000000001101001111100000000000111011
111001000010000001110011011111111101001000000010110001111011
110001000011111101110011010000000100000000000000000000000011
110100000111111101110011000111111111101110111000000001111011
110000011111111000000011110111100000001110000011101000001011
110010011111111011110001110011001111100000000000101001000011
110010011111111011100000000111000001111111111011101001001011
110011110000000000001101100110001111111000111011101001101011
110000000001111111000000000110111111110010100000000001100011
110000111100111000000101100110110000000010101111111101100011
100011000000000000000000100000000001111110101110000001100011
100000000000000000000011100000000000000000100000000000000001
111111111111111111111111111111111111111111111111111111111111
