111111111111111111111111111111111111111111111111111111111111
100000000000010111111111111111111011111111000011000001111111
100000001111010111110000000000000000000100010100000111111111
111111111111010000000111111111111111011110110101111111111111
111111111111010100000111111110000001011110100101111111111111
111111111111010001110111111111100000011110100101011111110001
111111111111011101110000000011110110011110000101011111110101
111110000111011101110000011111110110011111100101011111110001
111110111111011100110011111111110110000011101100011111110111
111110111111011110110011111111100110001011100000011111110111
111110111111011110110011111111110111100000001110011111110111
101110111111000000000011011111110111111111111111000011110001
101110111111111111110111011111110101111111000111000001111101
100000000011111111110111011111110000000000000000011101111101
1111101110111111000000010111111111111100000011E1000000111101
111100111000001101111101000000000000000000000000011101111101
100000111001111101111100011111111111000001111111011100000001
101100111001111100111101110100000000000001101111010000000011
100000111001111101111100000000000000011101101111011111111011
111000000001111100001111111110000000011000000000000000100011
100001111000000001101111111111100000011011111111111111111011
101101111011100000001111101111111100111000000011110011111011
111101111011101111111111101111111100101011011011110011111011
111101111000000000011111001111111100000011011001110011111011
111101111001111111011111000000000000001111011001110011111011
111000000001111111001111011110111111101111011000000011111011
111011101111111111000011011110111111101111000010111100011011
111000001111111111011100000110111111101111011000111111011001
111011111111111111011111110000000000001111011010000000011101
110011110000000000011111110011111111111011000011110000000001
100011110011111111111111110011111110000011111111110111111101
101110000000000000000000000011111111111011111111110110000001
101111111111111111011110000000000111111011111011110110101111
101111100001111111011111100000000000011000000001110110101011
101111101111111111000000001111111111011001111001100000101011
100000000000001111110000100000000000011000111011101110101011
101111111111111111111110100111111110111000111011100000101011
101111111111111111111110100111111110111000111000001110100011
101111111111111111111110001111111110000000111011100000001111
111111111111111111111111111111111111111111111111111111111111
