111111111111111111111111111111111111111111111111111111111111
100000000001111111111110000000110000000000000000000000000001
101111111101111111111110000000000111000000000000000001111101
101111111101100000011000000000000000000000000000010000000001
101110000100000000000000000111111011001111111101100000000111
101110111100000011111111110000001011001111111100111100000001
101110000000000000000000111111100011011100000100100000000101
100000011111111100101110110000000011011111110100110111011101
101110000000000100101110110000010011011111110100110011011101
100000000001110100100010000000000011011011110100110011010001
111101000000000100101111111111111100011011100000000011000001
100001111111100100100000000000001100000000000011111011011111
111101111111100000001111111101111100111010110010111000011111
111101011111100100000000111001111100000010110010000110011111
111101011111100100111111111000000001111010111000000010011111
100001011000000000000000000000000001100010000000001011000111
111001011000000001000001111001111001111010111111111011011111
111001011010110000110000000000000001111010100000011001000111
111001011010000011111111111111000000000010101111111011000111
111100011011110011111111100000011101111010101101101011110011
100000000011100011111111111111000000011000100101101011110111
10111101E111110000000000011111001111000000000001101010110111
101111011111110111111101000010001111100010100001101000000111
101111010000000000000000011110001100101110100000000011110111
101000000111111111110000011110001100000000100000000000000111
101100010111111111000111111110100000000000101111000001110111
101101110001111100000111111110100000000000001100000000000111
101001000000000001110111011010010111111111110101111100000001
101101000000000000000000011000010111111111110101110000000001
100001100000000000000110011110010110000000000101000000111001
100101100011111111110110011110000000111000000000000010111011
111000000000001011110000011000001100000011111100000000111011
110111111000000011000000000011001100000000000001111100000011
110100000000000011011110000000001010101000000000111101111011
110011111111011011011111110111101010101001111000000000100011
100000000000000000000100000111101010101000000000011100000011
111111110000111111010000000111101010100000000111111000000011
111111110000000000011110000000101010111000000000111000011001
111111110011111111111111111110000000000000000000000000000001
111111111111111111111111111111111111111111111111111111111111
