111111111111111111111111111111111111111111111111111111111111
111110000001100000000000000110100000000001110111111111111111
111111011101100000111111100000111111111100000111101111111111
1111E1011100001111000000001110111101111111100000000111111111
100000011100001111111111111110011001111111100000000111111111
100011110000101111111110000000000000001100000110110101111111
100000110010101111101111111111000111000000000010000101100001
111011110010101111101110001011000111111101111110110101111101
101011110010001111100110111011000000000001111110110101111101
101011110000011011101110000011011000000001111110110101100001
101011110000000000100111111001011111111101000000000000000001
101011110011110110101110000001011100000001111111011110001001
100010110000110110100000000001000000011100000111011110110001
100010110000110110101110111101111111011100000000001010111001
100010000011110000001110111101111110011100001111111010110001
110010111011110100000000000001101110011101000000001010111101
110000000001110100000001111101101110011101001111100010111101
111000001111110111111101111101101111011101001111001100010001
111011100000110111111100000001100001011100001111011111010011
111011101111110111100000111000000001011100000001011111010011
100000000001110000101110000000000011011100000001011111000001
101011000000110100000000011111111011000011011101011111011101
101011010000010000001111111111111011100010011101011111011101
101000000000000111101111111111111010000010011101001111011101
101111101000110000001100000111011010000110000000001110011101
100000001000000111101001000000011001100110000101101110000101
101111101011111000000000000000000011110110110100001110010001
100000000011111111100000000011111000000110110100100000010101
101100000100011111101111000000000011110000110100101111000101
101110100000000011100000000011110011110110110100001111000101
101110101111111111101111110000010011110110110100000000000101
101110101111111111100011111111010011110100110111111111111101
101110101111101111100000100000010011110000110110011111111101
100010101100000000000000001101010011110000000000111111111101
111010100101111110000000000101010000110000000110110111111101
111000000001111100000000000001000000110000010000000110000001
111000000000000000000000100001000100110111110110110110111101
111011111111111100000001100001000100110111110110110110111101
111011111111111100011111100000000000000000000110000000111101
111111111111111111111111111111111111111111111111111111111111
