111111111111111111111111111111111111111111111111111111111111
111111111111100000011111111111001111111111111000000011111111
111111111111101000000000111111000000011111100000011011111111
110111110000000011111110111111111100001011101111011011111111
110111111111111011000000111101000000100001101111000011111111
110000000001100000011100000100000000000001101111011111110011
111111111101111110011111110101100000111101101110000000000011
111110100000000000011111110101101110110000000000001110000011
111110111111111110011111110101100110111101111111101110111111
111100100000000000000000000000001110000000000000101110111111
111100110111111E11100000000000011111111111111111000000101111
111100110111111111101110000000011111111111111000000000000011
100000110100011110001110111111011000001111110000000000000011
101110110101111111101110000111011101111111111111111111110011
100000000001111111101000101111011100111111111111011111110011
111100001111111111100010100111000000100000000011011111110011
100001100000000000000010100011001100111111111000000011110011
111101111111111111111010100001001100100000000000010000000011
111100000001100000001010101111000100111111111111010000010011
100000011101101100001010101101110101101101111111010111110011
100000000001101101111010100000000101001101111111010111110011
111110001111101101111010111111100001000000000000010111110011
111110111111101100111010111111101111000000000000000111110011
111110101111101100111010111000101111110010011000000000000001
111110000000001100111010111110101000000000000000000000000001
111110111111111111111010000100101111111110110000000000000001
111100000000000000000000000000001010000000111111111111111111
111100111000011000001101111111111011111000000010000011111111
111100111111011000000101111111111011111001111111011001100011
110100000011011000000001111111111011111001111100000011111011
110001111011011001111111111111111000000001111111111011111011
110101111011011011111111111111111001111100000111110011111001
110101111000000000000000110001111001111100000111100111111001
110101111000000000101110111100000001111101110111110111111101
110101111101101111101110111100000000000001110000000111111101
110001111101100000000000111101000000000111110111000000001101
111101000000000111111110111101011111111111110100000111001001
111101011111111111111110111100011111111111110101011111001011
111100011111111111110000111101000000000000000001000000000011
111111111111111111111111111111111111111111111111111111111111
