111111111111111111111111111111111111111111111111111111111111
111100000000000000111000000000000011111111111111111111111111
111101111111111110111011111111111000000000001111111111111111
1111011111111111100000001111111110000000000000D0000000111111
11000111111111111110001111111111L110000011111111110000111111
111111011111111111000000000000000001111011111111111110111111
111111011111111111000111111111111111111011111111111110111111
100011011111100000000111111111111111111000000000000000111111
101011011111101111000111111111111100000000000000001111111111
1010110110D0001011000000000000000000000000111111100000011111
101011011111111011011110000000000000111111111111111111011111
101000000000011000010000111111111111111111111111111111011111
1011111110110000010000000000000000000D0000000001111111011111
101111111011011111011111111111111111111100011111110000011111
1011111110110000D0000001111111111111111101011111111111011111
100011111011011111011110000000111011111101001111111101000001
1111111110110111110111100000000010111111011011111111D1100001
1111111010010100D0000110111111000000000001000000111101101101
111111101001011111010110000001111111111101001100D00001101101
111111101001011111010110111001110111111101001111111101101101
111111101001000111010110111001110111111101011111111101101101
11111110100111010101D110111001000000011101011111100001101101
111111101001110001010110000000000000000000011111100000000101
111111000001111101010100000101001111011100010000001111010101
111100011111111100010100110101011111011101110000000001010111
111101100000D0D000000100110000011111011101110111111110010001
111101111111111111111100111111111111011100010111100000011111
111100000000000101110000000000100000011000010100000111111111
111111110000000001111111111110000000011000000111110111111111
111111111111111111111111111111111111111111111111111111111111
