111111111111111111111111111111111111111111111111111111111111
11011000111111000000011111100D00000D000000000000000000001001
110110101111000000000000111001111111111100000111111000000001
110110E01111111111110000011011000011111101001111111111111011
110110101111011111110111111011000000000000001111111111111011
110110100000000001110111111000011110011111101111101111111011
110110100000000000010011111011011100100000000000101111111011
11011010011101111101D111111D1101000010110000111110000D011011
100000000000000110010111111011011110101101100D00001111111011
100000011000000000010001111011011110101100100111111111111011
110000000011111101110000000000000010000000100111111111111011
100011011011111101110000111010000000000000100111111111111011
101111001010000001110010000000000111111100100000000000111011
101100001011111001100010011111100111111000100101110111111011
101111000011111000000010111111100111111100100100D00111111D11
100000010011111011000010001011100D000000001001D1100111111011
100010010011111011000010101011100111111110100000000111000011
101100010011111011000010100001100001100000001111100111111D11
100000110011110011000010111111100000000000100000000011101011
100000110000000011110000110110000111110110100000001111101011
1111001101111100000000000D0000010111110110000000010000001011
11110010011111000000000111110110011111011111111111011100D011
111100100111110011111111111101100111000000000001110111011111
100000100000000011110111111101100111101101111111110111011111
1000000011111100111101111111001001111D1101011111100111011111
100000000000000001110111111100111111000000011111100111011111
101111111110000001110011101100111111001000001111101110011111
101111111111110001110000000000011111001010011111100000000001
101111100000000001111111110110011111000000000001100000000011
111111111111111111111111111111111111111111111111111111111111
