111111111111111111111111111111111111111111111111111111111111
100000000000001111111111111111111111111111111111111111111111
101111111111101111111111111110000111111111111111111111111111
100011111111101111111101111110110000000000000111111111111111
101111111111101111111101111110110111111111111111000000000001
100000000000001100000001111110110110111111000000000000000001
101111111111101100000000000000110110111111111111111111111101
101111111111101101101100011111110100000000000000000001111101
11111111111110000110000000001111011111111111111111110E111101
111111111111101111111111111011110111111111111111111101111101
111111111111101111111111111011110111111100000000011101111101
111111111111101111111111111000000000000000000111011101111101
110000000000000000000111111011101111000001111101011101000001
111111111111100000000000000000001111011111101101010001111101
111111111111101100011111000011101100011111101100010111111101
110000000111101100000000111111100000010001101101000000000001
110111111100000000000000000000000000000001101101110111100001
110111111111111000000111100000000000111101101101110111111111
100111111111111111111111101111111111111101101101110111111001
100111111111111111111110100000001100000001101101110110111101
100000011111111111111110111111101101111000000001100110111101
101011111111111100000000111000001100000000001111101110001101
101011000000000111111110001111101111010011111110101010101101
101000011111110111111110101111101000010011111110101010001101
100011110001110111100000101111101111010010000000000000111101
101111110000000011111110001111101111010000000101111111111101
100000000000000001111111101111101111000011111101111111100001
100111111111101011111111101111101111000000000000000011111101
110111111111101000001111100000101111000111111111010000000001
100111111111101010000011110000000111000111111111011111111101
101111100000001011111011111100000000000011111111011111111101
101111101111111011111011111101111111111011111111011110000001
101000000111111011111011111101111111111011111111011110000001
101111101111110010000000111101111111110011111111001111011101
101111101111110100111000000000011111110011111111001111011101
101111101111110010111000001100000000000000000000000001011101
101111100000100010110000001110000011111111111100011111011101
101101101110100110111111111110100000000000000011011111011101
100000001110000000001111111110100000000000111000011111000001
111111111111111111111111111111111111111111111111111111111111
