111111111111111111111111111111111111111111111111111111111111
100001111111001110000000000000001111111111111100000000000001
100001011111001110111111110111111111111111111101111111100001
100111011111001110111111110111111100000111111100000001111111
110000000000001110111111110111101101101111111111111101110001
110001000011101110001111110111101101101111111111111000000001
100101011111000000000000000111101101101111111111111011111101
1111000D1111111111110111111111101101101111111111111011111101
11111111D111111110000000111111101101101110000000000000011101
111111110111111110010000111100001101101111111110000000000001
111111110111111110000011111101111101100000000000000000000001
111111100111111100111111111101111100111111011001110111111101
100000110111111101111110111101011101111111011011110111111101
101111110111111100000000000000011001111111011011110111100001
101111110111111111111111111000011011110110001011110000011101
101111110111011111111111110111011011010110111011110111000001
101111110111011111111111110111011011010000000011110000111001
100000000111011111111111110111000001011111101100000000111001
100111111111011111111111110111111101000000001111111100111001
100111111111000000000000000111111100000001000111000000111001
100111111111111111111011110000000000000001110111011010111001
100110000001111000000000000011111111111101110111000010111001
100000111100000000000111111011100001111101110000000000000001
100110111100001111111111111011101101100001111111111111101101
100110111101111111111111111011101101111101111111111111101101
110110111101111000011100001011101100000001111111101110001101
100110000000000000111000001011101111110111111111100000111101
100000000001000000000001101011101111110111111110000000000001
101011111111011111111100000000001111110111111111100101111001
101011111111000000011100111110000011110001111111100101111011
101000000011111111111000111110111111110011111111100000000011
100011111011110000011000111110101111110011111111111100000011
111011111011111111011000111110101111111011110000011111111011
111011111011111111011000111110101111111011111111011111111011
11101111100000000000000011000010E000000011100000001111111011
111011111001111111111111110011100000011111111110101100000011
111011111001011111111111110000000000001111001110101111110001
111011111001011101111111110011111111101111001110001111110001
111000000000000001111111110000000000100000000000001111111101
111111111111111111111111111111111111111111111111111111111111
