111111111111111111111111111111111111111111111111111111111111
111111111000001111100000111111000000001101100000000000000111
111100001011111111111110111111001011101101101111010000000011
111111100011101111111110000000001011101101100000001000000011
100000000011101011111111111100000011000001101110101011111111
101111111010100011101111011111111000001111101000000000111111
101111111010100011101100010111111000000000101011011111111111
101111111000000010001101110111101011111110001011011011111111
100000111001100011100001110100000001111010111011011011111111
100111111001111011101111100000001011000010111000011000000001
100111111001000011101000111111000011110010111011000001110001
111111111000000011001000000000000010000000000011000011110011
110111111001111010001000110000000011110010110011110100000011
110111111001111001100010111111100011110000100011110111110011
110111111001111000011010111111100000010010111000000011100011
110000001001101000111000000000000011110010111111100000000011
110000000001001000111010000000000011110110111111100000000011
110111111001000000011011110000000011100000101111101111000011
110111000001001000011000000000000011100000000000001101111111
110111000000001001010000000000000000001110000000001101111111
110000011111001001011000011000000000001111111111111101110111
100000011111001000011011100011111110011111000111111101110111
101111100000000001011011111000000000000000010000000100000001
100011111111111000011011111010000000000001010011100000011111
111111111111100001100011111011111111111101010011101110011111
111111111111101001111011111010000000001101010000000000011111
100111111111000001000011100010111111101101010011000000011111
100011111111110000000011101110110111101100010011111110011111
111000000011000101111111000110110000001100100000111110011111
100000111011010101111100000110110101111100100000000000000111
111000011011000101111110000100000000011100100000010111010111
111111010000000101110110000111111110000000000111110000000011
100000000000000101110110000111110000010101100111111101011001
101110110110111100000000000000100000010101100000000101001011
10110000011011111110111100000000000001010111111111000E000011
101000000110111000000110000000000111110101011111110111010011
100001010110111000000000000000000000000000000000000111010011
101001010110011011111111100111100000111111111111111000010011
100000000110000011111111100111000000111111111111111111000011
111111111111111111111111111111111111111111111111111111111111
