111111111111111111111111111111111111111111111111111111111111
11111111111111111111110000011111111S111111111111111110000001
111111111000000D000D0000000011111100000000000000000000111101
111111111D11111111111111111111111111111111111111111110111101
1111100000111011111111111111111111111111111110000D0000111001
11111D11111110111111111111110110100000D000111011111110111001
100000111111101111111111111101101101011100111D110D0000000001
100000111111101111111111101000D00001011100111011111111011111
1010000000000000011111111010111111110D0D00001000000011011111
101011111000000111000000000011111111111100111111111111011111
101011111111110111000000010011111100000000111111111111011111
101011111111110111110110000000000000000000111111111111011111
101001111111110111000000000000011111010000111111111111011111
101000001111110111011100000011111111010000111111111111011111
101011111111110000011111101011000011000100111111111110011111
100011111111111111111111101000010000011100111111111110111111
111011111111111110000000001111011111011100111111111110111111
111011111111111111111111101111000000011100111111111110000001
111011111111111111111111101111111111111100011011110000000111
11101111111111111110111110111111111111110001101111D111111111
111011111111111111101111101111111111111100011011110111111111
111D11111111111111101111101111111000000001000011110111011111
110011111111111100001111101111111110111000000001110111011111
110111111111111000000111101111111110111011111101110111011111
110010000000110111100111100011111110111011000D01110111011111
110011111110110111100111101111111000111011111100000000000111
110011111110110111100111101111111011111000001101101111111001
110011111110110111100111101111111011111011111101101111111001
100000000000000000000000001111111000000000000001100000000001
111111111111111111111111111111111111111111111111111111111111
