111111111111111111111111111111111111111111111111111111111111
111110000000000000001111111111100010000000000000000000000001
111110000111111111101111000000001111111111110000111111111101
100000111111000000000000000000000011111111110111000001110101
111000111110000000000000000011001010111111110111111101110101
111110111111111111111000001111001010111111110111110100110E01
101110000000000011110011000000000010101111110000000000110101
101110000000110000010000001111000000001111111110001000110101
101111111111110011110001111111111111101111111110111000000101
101111111111110011110001111111111101101111111110000001011101
101110111110000011110001111111111101101111111110000000000001
100000111111111011110001111111111100100000000010111110000001
111010111111100000000000000000111100111111101010111110110101
111000011000101100000000000000000000111111100000100000000101
111010111110101111111000001111100100000000001010101111111101
111010111110101111111101111111100000001111101010101110000001
111010111010101111111001111111100111011111101000101111111111
111010111010101111111001000001000000000000101010101111111111
111010000000000000111001011111101110111110101010101111111111
111010111111111111111001011110101110111110101010100000001111
111000111111100000111000001110100000111110101010101111100111
111010111111101000001011000000000111111110101000101111001111
101010000011101111111011101111110111111110001111101111101111
101000000000001111111011101111110111100000001111101111101111
100000000111001111111010000000000011101000001111101111101111
111000111111011110000010001111100011101110001111100000001111
111111111111000001101110001000000011100010000000000011111111
111110100000001011101110001011110000001110101110000001111011
100000000001101000001110001011110010001110101111100000011011
100111000100001011110000000000000000011110000000100001011011
100111011100111011100000111101110110001110000001101111011011
100111011100111011101111111101110110000000111111000001010011
100111000000111000001111110101110110000000111111000000010011
100000011110000000000000000000010110111100000011000000010011
100000011110111111100000000000000110000000011111001100010011
111111011110000111111111011101100000100101011111000000000011
111111000000000000000111000000000011100101011111011001111011
111111011110111111111111010000000011100101000000000000000011
111111011110111111111111000010111000000001011111111111100001
111111111111111111111111111111111111111111111111111111111111
