111111111111111111111111111111111111111111111111111111111111
101111011111111111000000000000000000100010000000011111111111
101111011011111101011111111011111111111010111111111111111111
101110011011111101011111111001111110000010100000111111111111
101100011011111101000000011001111100111010101110111111011111
101111011001010001011111100000111000111000001110000000000011
100011001001011101011110001111111000111010111111001111110011
100000001000000000000000001111111000000000000011011100000011
111111001011111111111111001111111000011110000001011111111011
110000001011111110111000001111000000011110000001011111111011
110110000000000010000011001111011110000000111111011111111011
110110111111111110001000001111011110011100111111001111110011
100110111111111110101000000000011110000000011111001111110011
100000000000000000001111101111111000000000100000001110000011
100111111111111111000000001111110000000010111000001110000001
100E11111111111111000111111111111111111010111111101100111101
110111111111111000000000011111000000000010111111101110110001
110111111111111111010001111111111111111010111111001000110101
100111111111111110D10000011111111101000010011111001011110001
100111111111111110010111111100001101110000111111001001111111
100100011111111010000000000111001101110110100000001000000011
100001011111111000000001110000000001110110111111100001100001
100000001111111010111110000011011101110100000011101001100001
100000000000000010000010111011011101010100111111100000000111
101111111100000010011000111011011100010100111111111100000001
101111111111111010001011111011000000000100111100000000001111
101111111111111010011011111011111110000000111111000001111111
101000000000111000011000111000000110011100111011111101111111
101111000000111000011011111011111100000100000000000001111111
100000000010000000011010111011000000111000110111111100000111
100000111110011100011010111011111110111011110000000100000011
100000011000001101011010111011111110111010110000000000000001
101111100111011101010000000011111110111010110100000001111101
101111101111011101011011111010000000000010000101111111111101
101111101111011100011011111011000010111110001100000000000001
100000001111010000011010000011111010111100001100111111111101
101111111111010110000011111011100000000000001100111111100001
101111111111000110111111111000000000111111101100111110000001
100000111111000000111111111111100000000000000000000000000001
111111111111111111111111111111111111111111111111111111111111
