111111111111111111111111111111111111111111111111111111111111
11111111100001111111100000000000011111100000000000D000001111
111111110010011111111010111111110111111011111111011111111111
111111111000000001011010111111110111111000011111010000011111
1111000000000001100D0010010001110111111011111111010000011111
111111111111110111111110110000000111111011000000010110001111
111111111111110000000000000011110111110011111110000111101111
111000000000000000000000000000000011110011111110111111100001
1110001111111110000000000000000000D0000001111110111110000001
111010000111111011110000000000111111111101111110111110000001
1110000000000110111101111111100000111111D1111000111110111001
11111011111111000111010000000011111100000111110011111D111011
101110000001110111110101111110000000001100011100111110111011
101111111001100111110100011110111111111101111100000110111011
1010000D0001100000000101111110111101100001111100111110000011
1010011100001111100101011111101111011111D1111100111111111111
101001111110111111010101111110000000000001111100111111111111
101001111110000000010001111110011011111111111100001111111101
100000000000000111000111100000000000000000001100110000111101
110111110111111111011111111110000011111111111100111110111101
110111110000000001011111111110111011111111111100111100000001
1101111100111E11110000D0000000111011111000D00000011101111101
1101111100000000110111111111000000D0000111111111000000000001
110111110000000001011111100000000011110111111111011100000001
110011110111111001011111100011111111110111111111010001111101
1100110100000000000111000011111111111101110D0000011100000001
110000000000000011011111101111111100000011111100111111111111
110110111101110111000111101111111000000011111100000001111111
110000000000000111000000001111111101111000000001111111111111
111111111111111111111111111111111111111111111111111111111111
