111111111111111111111111111111111111111111111111111111111111
110111101011111111000000000011011111111111111111111110111101
110110000011100000010000011011011111110001111111000000000001
110000000000100000000111000011011111111000000000011110000001
1011011100000001000100D0000010011111111000110111011110111111
101101110000100100000111001000011111011001110100011000111001
101101110000100101000000011000011000000001110001111110111101
101101110110000100011111111000000001111010100001110000111101
10000111011000000100000000000000001111101001110111111D111101
11110101D110001101111111111010000001111010101101100010111101
11110001011000110D011000000001111001111010101001100110001101
111101010000001111111111011000000001111010101001100111111101
11110101011100101111111100L000111101100010000001100001111101
1000000100000010111111110010001111011110001110001011000D0001
1000000000011010101000D0001000000001101011000001100000011111
100000000001101010111111001000000001101011000000000000011111
101000000000001000111111001000000001101010011111111110011111
10001111000110111000000D001000011101100010011111111110001011
1010111110000011100000110010000111D1111010011111110000001011
111000011010101110111111001100000000001010011111100000001011
111000000000001000000000000000000001000010011111100000000011
111011111011101000000010000000101111111010011111001111100001
100011111011101000000000010110101111111010000011100010000001
100111110000001011111000000000000001111010011111101100000001
111011100000001000000000000000000000000010000000001111100001
1110111D1011101000000011100111100000000000000000000000000001
11101110001110000000000D000110000000000100000001010111110001
111011101101101111100111110000000000011101101101010111110101
111000000000001111100000000000000000000000000000010000000001
111111111111111111111111111111111111111111111111111111111111
