111111111111111111111111111111111111111111111111111111111111
111111000000000000000000000000000000000000011111111111111111
110111111111110111111111111111111111111111111100000100000111
110111111111110110111111111111111111000000000011110101000001
100000111111110110111111111111111111111111111011110101011101
101111111111110110111111111111111111111111111011110101011101
101111111111110110000000000000000000000111111011110101000001
100011111111110110111111111001111011110101111011110101111101
100000111111110000100000000000001011110101111011110101111101
101111111111110000101000000011111011100000111000000001111101
101100000000110111101011111111111011111010111001110011111001
101100000000010111101011111111111000000010111001110011111111
101101111E00000111101000011111111111111110000000000000000001
101101111101111111101111011111111111000000111101111111111101
101101111100000000001111001101111111110000111101111111111101
100000000011111001111111001001111111110000000000001111111101
101111111111111101000000001000000011110111111100000001111001
101011110000011101110001100011100000000111111100000000111001
101011111111011000000001100000000011000001111100000000000001
101010000010000000000000001111111000011111111111111111111111
100010111110100011100000000111111111011111110000000000001111
110010111110000011101000011111111111011111111111110000000111
110000011110111000001110010000000001011111111111111110000111
110110111110111110000010000001111101000000001111111111100111
110000111110111111111010011111111101001111111101111111100111
110000000000111111111000000000000001011000001101111111100111
111000000000000111111111100000001101000000000000011111100111
110111111111111000000000000000001101111111100000011111100111
110111111100000011100000001111111101111111011001011111000111
100101011111111011101100000000011101111111011001001111000111
100101011011111011101101001110111101111111011001101111001111
100101011011111000001101111110111101111111011001100011001111
100100010000000001100001111110111100000000011000001011001111
100101111011110001111111111110111111111011000001111011001111
100101111011110001111111111110111000000011111100000011001111
100001111011110001111111111100111011100000000111100000000111
111000000000000000011111111100000011110111110111101111110111
111001110011110001111111111101111010110111110111101100000011
111100000000000011111111111100000010000000000111101100111111
111111111111111111111111111111111111111111111111111111111111
