111111111111111111111111111111111111111111111111111111111111
100000011111010000001111101111100000000000001111111111111101
100111110111010000000000001101101101111111111100000000000001
100101110000000111100111000000000000000000000000000111111111
100101000000010111100000011000000000000000000000000111111111
100101110000110111100001111111100000000000000000010000000001
100101110111010111110100000001101111111101110111100000010001
100001110000010111110111111111100111111100000111111111011101
101101110111010000000000000000000000000000000011110000000001
100000010111011111111111110000000000000111110111110000000011
100111110111011111000000000000001100100011110111111111110111
100001110100000000011000000111101000100000000111111111010011
101000000100000100011011111111101000000011110111000000010011
101000000101111101011011000000000000010011110111011111010011
101000010000000001011011111111001000010011110100000000000011
100011101111111101011011111111001110010011000000000000000011
101000001111111100000000111111001110010011111100111111100011
101111101011100000000010000111101110000000000000111111100011
100111101000000001111010111111100000011111111110101111100011
100011001011111101111010000001101110011111111110101111100011
100000101011111101111010001111100000011111110000101111000011
101111101011100000000010111111111110011111110111101111011011
100000000000000000000010111111111100100000000000001111011011
100000000001111111111010111111111110000000000000001111011011
100000001110111110000010111111111110111000000001101111000011
111111101000000000001010111111111100111000000000001111011011
101011001110010000000010111011111100000011111111100000000001
101010000000011011111010111011111100101000000000101111000001
101011111111011011111010111000001100101011111111101111010001
100011111111001000000000011001111100101011000110100000010101
101011111111011011111111011011111100101000001110101110010101
101000111111011011110000011011111100001011101110001110010101
10000011000000001111111E111011111110001011001110101110010001
111110111000000000111111111011110000000010001110000110010111
100000001011111000000111111011111110000010001110000110000111
100000000011100000001111000000001110000000001110110110110111
111111111111101111001111011111000000110111001110110110110111
111100000000000000001111011111010000110011000000010110110111
111111111111111111000000011111000000110011000110000000000111
111111111111111111111111111111111111111111111111111111111111
