111111111111111111111111111111111111111111111111111111111111
111111111101000000000000100000001101111111111110000000000011
101000000000000011011111101111111101111111111111100000111111
101D11111101111111011000100000011100000000011111101110000011
101011111101111111011011100000000000111111011111001111111011
101011111001111111011000000000011110111111011111001111111011
101011D11101111110011011111111011110111110011111000011111011
101011111101111111000001100000000010111110011110000000001011
101010000100001111001101111111011000000000000000000000001011
100000000001101111001101111111000001111101111111000000001011
100000000001101111001101111111011101101101111111000001101011
100110111100001100001001111111011101101101111111011111100001
100110111100000000000000011111011100000000000001011111101111
100110111111000000000000000001000001111100000000000000001111
100110111110111111110111111100000000000000111111000011111111
100000011110111000110111111100111111111111100000000000000011
100111010110111010110111111100111111111101110111110000001011
110001010110111010000111111111111111111101110111101110001011
111101010100000000010111111111111111110101110111101111101011
111101010000010000110000111111111111110101110110101111101011
111101000111110110100111111000000011110100000000000000000011
111101000000000000101D11111111111011110000000001111100101011
1111010000011101E0001011111100001000000000001100000101101011
111101101111110111110000000000000000000000110101111101100001
100001101100000111110000000000001100011111110101111100000101
100000000001110101111111011111111100010000000001111100010101
101110111111110101111111010000000100010000000000111100000001
101110111111110001111111010011111100000000100000101100111111
100000000001111001111111010000000000011111111100000000100001
101111101111111001111000000000000000011111111100010100000001
101111000000000001111001111000000000011111111100010111111111
101000011111110001111011111011111111111111100000010111011111
101111000000001000111010000010000011110000000000000000011111
101111000000111000111000000000111111110110111111000000011111
100011011111111000110001111000111100000110111111111111011111
110011011111111010010011111000100001110110101111111111011111
110011000000011010010011111000101111110000101110111000011111
110011111111011000000011111011101111111100101110000010011111
110000000000011111000011111000001111111100001110000000000001
111111111111111111111111111111111111111111111111111111111111
