111111111111111111111111111111111111111111111111111111111111
111111111111111111100001111110000000110000011111111111111111
100000111111111111101101111110111110111111011111111111111111
110111100000000111001101111110111110111111010000000001111111
110111101111110111000000001110111110000000000000000000000001
110111101111000000011111111110000000111111111111111110011101
1E0000001111111111111111111111111111111111111111111111011101
100000001111111111000000000000000000000011111111111111011101
101101101111111111111111101101111111111111111111111111011101
101101101111111111111111100000000011111111111111111111000001
101101101000000011101111101101111111111111111111111111011111
100001100111111011101111100001111111111111111110000000000001
110000000011100000000000000111000000011111111110111111111101
111111110000011111111111100000000000011111111110011111011101
111111110010111111111100001111011111011111111110011111011101
110111110010111111111101101111010000000000111110011111011101
110111110000111110001101101111011111001111111110011111011101
11011111010011111D011100001111011111000000000000011111011101
110000000100000000000000001111011111011111110110000011011101
110111110000000000011111001111011111011111000000111000000101
110111110100000000000011001111000000011111011110000000000001
110111110100000000011010001111111110000011011111111111111111
110111110101111111111011001111111110010000011111111111111111
110111110101111111111011001000001110011111000111110111111111
110111100101111000001011000000001110011111111111110111111111
110111100101111111101011000011001100011111111111110111111111
110111100101100000101011001101101100011111111111110111111111
110000100100001110101011000D01101100001111111110000010000001
111110000000000010000000000101101101101111111111111011111101
111110111011101110011100000101001101100000001111110001101101
111110111011000000010000100101011100011110101111110011100001
111110000001111111000000000100001100011110000000000000000001
111111111111111111011111110001101111111111100000001111101101
111111111111111111011100000101101101111111101111111111101101
1111111111111111110111011111011011D1110111101111110000001101
111111111111111111011101111101100000000011101000110110001101
101111111111111111011100000001101000D00011101000000110100001
101111111111111111011100101100000001011011101111111110111101
100000000000000000011100100000000000000011100000000000000001
111111111111111111111111111111111111111111111111111111111111
