111111111111111111111111111111111111111111111111111111111111
100001111111000111111111111110000111111111110000000000000001
101001111111010001111111100000011111100000000111111000001101
100001011000010000111110000000000011100000000101111011001101
111101011111010111110000001111111011101111010101111011000001
100000000111010000000000000001111011101110010000000011011111
111010000011001111111111101101110011101100010111111000011111
100011111010011011111111101101110011101110000110000011011111
100001110010011011111111001101110011100000000110111011011111
100011110011011010000111001101110000101101000110111011011111
111111100000011000110001001101110100000001011000011000011111
101111111100011010110001001100000000000100011111011011011111
101111111101111010111101111111111100000111000000000011011111
100011111101111000110000000001000111110000010011111111011111
101000000000011111111100111100110011111000010011111111011111
101011111001111111111100111100100000000000010011111000000011
100011111101011111111100000000001111111110010011100011111111
111111111100011000000011011000001011111110010011111011100001
111100000100011111110000000000001011111010010011110011000011
100000000000011111110000000001101000111010010011110001011111
110100000000011110000111000000001010111010011011110011000111
110011111111000000110111000111100010011010011000000000000011
110111111111111000110100000011000000111010011111111111110011
110001111111111110110000000011000110011010011110111111110011
110111000000010110111110111011000000000000000000001111110011
110111011111110110111110110011000001111111111110000111111111
100000000001110110111110110011001010100000000000000000001111
100000000000000110111110110000001010111111101110011110111111
101000011101110000000000110001001010111111101110100000011111
101111111100000000000000110001001010111111101000001111111111
101111111111100000000000000001001000000011101110001111111111
101100000000000100010000000000001001101000000110001111111111
111111100001100000000000110000001001100011111111100000011111
111111101101101110011110000000001001100000000000101110000111
100000000001100011011110111101111001100000000111100000111111
100111101101101101000010111101111001100001110011100000000001
100111101101101101011110001E00000000000001110110111111101101
100111101101101101000011001101111110000000000000011111101101
100000001100000001011111000001111110000000000000011111100001
111111111111111111111111111111111111111111111111111111111111
