111111111111111111111111111111111111111111111111111111111111
111111111111000110110100000001111111000000000000000001111111
111111111111010110110111100001111111000000000000000000000001
100000000011010110100100000000000000011101111011111110111111
100111000001010110100000000001111111011101111011110110000001
101000011111010000000000000001000000011100000011110111111001
101111000000011000000001100001000001111111111000000110110011
100000001111011000001001110001011111111101111011101110111011
111111111111000000000000110000011111100000110011101110000011
111101111111010001111000110000000111011110000000000110111011
111101101111011101011000110000110111010110000000110110111011
111101101111000000000000000000110110010110111110110000000001
100000000000011110111111111110110010000110111110111000000001
101101111111100000000000000000110110010000111110111111000001
101101111111101111110101111100110110010110011000000000011111
100001111111100001110101111101110110010110000000111111111111
100000001111101000000101111101110110010110000000010111111111
100000100000000000000000101101110110010110111111010110000111
111111111111100000000011101101110000010110000000000110111011
111110000000001110111001100001110110010110101111111110111011
111010111110001010111011111101110100010100101111111100111011
111010011000001000E11010111101110111010110100010000000111011
111010000000001010011010111100000000000000000000011011111011
110010001100000010101010111100000000000111000000010000011011
100000000100011110100000111100111111111000011101000001111001
100000000000001110100000000000000111111011001101011111111101
111100001111101100100000111100111111111011101101011111111101
100001000000000000000000000001110111111011100001011111111101
111101000001111111111110000001110111110000111001011111111101
111101111111111000011110000100000011111110111000011111111101
111100010001000011111111110000111000010100000000001110111101
111101110000000000000000010110111000010100111111111110110001
111101110001111011111111110110111010110100000001111100111101
111101110111111001111111000000011000110001000000001100111101
100001110011011011111110000000010000000101000000000000000101
100000000111010011110000000110001001110101001111111000111101
101111100111010011110111111111011001100000000011111000000001
101111100111010000000000111111001000000000000000011000111101
101100000000000000000000000000001111111111111111000000111101
111111111111111111111111111111111111111111111111111111111111
