111111111111111111111111111111111111111111111111111111111111
1D0000111111110111110001111110000111111111111111111111111111
111110111111110111110111111111010000011111111111111111011111
111110111111110000000011111111011111111110000000111111011111
111110111111010000000000011111011111111111111110111111011111
111110111111010111111100000001011111111111111110000000000001
111110000001010000001111111101011111111111111111111101110001
111110000001010010000000000000011111111100000000000000000001
111110001111000010111111111101111111001100000000000111111001
111100001111100010111111111101111111101101111111101110111101
100000001111101010111111111101111000001101111111101110111101
111111101111101010111111111101111111101100000001101000000001
111111100011100010111111111101100000101111111100101000111111
1111111110111D0010110000000100000000000101100001101000111111
100011111011110000110111110111100000000101111101101100011111
101111111000000000100111110111101111000000000001100000000001
101111110010000000000111110011101111011110000001111000000101
100111110011111111111111110011101100000110111111111111100101
101111010111111111111111110011100000000110111111111111100101
101111010000000000000000000000011111110110000000001111100101
101111011111111111111101111111011111100100011111100001100101
101111011111111110000000000000000000101101111111101111100101
101111011111111111101111111111111110101101101111101111100101
101000000111111110100000111111111110100000000000001110000101
1000100000011100001011111111111100001001111111E1101100010101
111011110111100000100000001111110111100111111111101110010101
111011110111111100001111111111110111100110000000000000010101
101000110111111100101000000000110000000110100000001110000101
101000000111111100101111111110000111100110110011100000111101
100010111111111100001100000000000111100110111011111111111101
111010111111100000000000000111D10100001100111011000000000001
1110100000000001111111111101111D0101111100111011111111111101
111011110000000111111100010111110101111100000001111111111101
111011110111110111111101110111110101111100011111111111111101
111011110111010111111101110111110100000000111111111111111101
111011110111000111100000000111110111111111111000000000000001
111011110111011000000000000000000111111110000000001111111111
111011100111011110001111111111010111111110000000000011111111
111011100111000000000111111111000000000000000000000011111111
111111111111111111111111111111111111111111111111111111111111
