111111111111111111111111111111111111111111111111111111111111
101111111111000000000000001111111111100000001111110000001111
101111000000011111100000100000000001101101111111100111001111
101111111111000000000110000000001111100000000011110111011111
100111111000000011111110110000000001000111110000000111011111
100000000001111111110000000000000000000000000000000000000111
100000111101111110000111111110000000110111000000001110110111
100000111101101111100111110001111110110111011111001100000001
100000001100000000000111111000000010010000011110000000111111
111111111111111111111110000000001010111000111111101110101111
111111111111111100000000000010111000001111111110101110100011
110111111011000111111110100000000010111111111110100000000111
110111111000110110111110100000001000000000001110101111100111
110111111010110110100000101111111000000000000000100111000001
110111111000000000100011101110000000000000000000000000000001
110000000110000000011000000011110001101111111000100000000001
110111111111111101011111111011110000000000011100100011111101
110001111111101100011111100000010000000000011100101111111101
110000000001101100000001111111011111110000000000000000000001
110111111000001111111001111011000000001100000001101010111101
100000000000000000000001111011000000011111110000001010111101
101000011111111000000000010011011110111111111110001010111101
101011000000001111111100000011001110000000000000001010000001
101011010001111100000001111011000000000000000000001011111111
101011010000111100001101011011000000000000000011101011111001
101001010111111111100001011011110001100000000011101000000001
100001010111110111111001011011100001000000000000001000000001
100001010101110000000001011011111100000000111111000000000011
111001010100000001111101011000000001111101000000001011111111
111001010101111011111101011011111000000000000000000000111111
111010000000001010000100011001111000000000001111111110110001
111010110110111011110101111010111111000000001111111110000001
111010110110111011110100001010001000000011000111111111111111
110000110100111000000001111010101010111101001111111111111111
11000011010011E000000011111010101000011101000111111111000011
110111110100111001111100000010101011111100010111111111111011
110111100100000000000000000010100011111101000000000001010011
110111100000011000011110111010111011110000000000000011011011
110000000000000011111110111000000000000111111111000000000011
111111111111111111111111111111111111111111111111111111111111
