111111111111111111111111111111111111111111111111111111111111
110000000000000000000000000011111111111111000000011111101111
100000111111111111111100000011111111111111111111011011101111
100000000000000000000000011000000111111000000000000000000001
100000000000001111001111111111110100000000011111111111111111
111111111111101111100000011111110111111111000000000000001111
100000111111100111100000001111110111111111000000000000001111
100111111111100000111101100000010111111110000000100000000111
100111111110101111111101101111010111111111011110111011110111
100111111110101111111101100000010111111110001110111011110111
100111111110101111111101101111000111111110000000000010000111
100101111110101000001101100000010111111110000000011011110111
100101011000001011111101101111100111111110011111111011110111
100101011011010000000000000001100110000000011111111011110001
100001011011011111111111000001100111111111000000111011011111
101100011000000001111111111101100111111110011111111011011111
100000000000111101111111111101100000111110011111100011011111
100000000000001101111111111101100110110000111111100000000001
101111111111000001111111111100000110111110000011101111111111
100001000000000000000000000000000110100000010010000000000001
101111011000011111110111111111111110111111000011111110111111
100000011111111111110111111100011110011111110000000000111111
101111000000000000010111111101111111011111010000000110111111
101111101111111111000111111100011111011111011111110110111111
100001101111111111000011111101011101000000011111110000000001
111100101100000100001111111101001001011100000011111111100001
111000101101111101101111111101000001011101111111100000000101
100000001101111101101111111100000001011101100000001111111101
111101101100011101101111111011111101000000000001000110011101
111101101101100000000000011011111101001111111110010110011001
111101101101111011110111111011111001000000000000000000000001
101101101100001011E00000111011111000000011111000000001111101
101101101101111011100111111000111011111111110000000001111101
101100000000000011100001111011100011111111000000000111110001
101111100000000000101101110011111011111111111000000000000111
101111100111111110101001100111111011111111111001100000010111
101111100110000010101001101111111011111000000001101101110011
100000000000011010000001101111111011111111111001101100010011
111111111111111010000000001111111011111111111000000000000011
111111111111111111111111111111111111111111111111111111111111
