111111111111111111111111111111111111111111111111111111111111
100000000000000111111111100000000000000000111000000011111111
110110010111111111110000001111111011000000111111111011111111
110000010111111111111111000000001011111110000011111000000011
110101110111111111111111101111110000111111111011111000111111
100100110011111111111000000000010000000001001011111011111111
100000110000111110111111100111110011111111101000000000001111
101000110000010000000001100011110000000000000011100000110111
100000100000000111111110001110110011111111111111101111110111
101000000010010101111100001110000010000000111111101111110111
100001111011110000000001101110111010111010111111101111110011
101100111011110100000001101110000010111010111111101111000111
101100111011110100000001100000110000000000111111101111011111
111100111011110101111111101111111111101111111111100000011111
111100000011000000000111100000000000000011111111110000000001
111100000011110000110000101111111111000000000000011101111101
100001111110110111110000000000001111011110100001011100001101
101111110000010000010100000000000000000000101111001100001101
101000000110000000110000010000011111111111101111000000000001
101000000110111110110100011111000001111111101111011111111111
101001110110111110110101011111111111111111101111000000000001
100001110000000000110101011111111111111000001100011111111101
111100111100000000110001011111000011111000100000011011110001
100000111011111010111111011111011001110110110000011011111101
111100000011100000111111011111011001110110000000000011111101
100001000011111000000000000000011001110110011111011011000001
111101111011111110000001110111011000000110011111000000111111
111101110011111110000111010100011011100000011101011011111111
111101110011111100000000010000011000101111011101011000000111
11110000000000111111000001000D010011101111011000011000011111
100000110000001111111110000000011001100000010101011111011111
111100110111101111111110011111000001111111010001011111011111
111100110001101111010110011111001111111111000000000000000011
100000000000000000000000000111001110111111110011011100001111
100001100011100000111101110000000000000111010000011101101111
111101111011101111111100100110000111110111011111011101101111
100001111011101111000000000100000000000000000001011101101111
111E11111011101111111101100100000000001111110000011101100111
100000000011101111111100000001111111111111111111111001100111
111111111111111111111111111111111111111111111111111111111111
