111111111111111111111111111111111111111111111111111111111111
111101111110000011111000000011111100000000001111000000000001
111101111110111011L11111111011111100000111011000011111111001
111100111110111000001111100000D01111110111011011001111000001
101101111110111011000D0111001111111111010D000000011110000001
100101111110000011000101100000000D00000111100011D11111111001
101101000000111011000000011000000110000111101000000000011001
100001000000000000000111111011111100001110001111011111111001
101101111111110000001111110011111101001110000000011111011001
100101000001000000001111110011111101000010011111101111011001
1000000000000000000010D0000011011101001110000000000111000001
111001111111111111101111110010000000001110000000010111011101
1101D1111100000000000000D00001111111001111110000000011011101
11000D000100000000011111111101111110000000111111100001011101
10010100000000000000000000000000000001111D100000000000011101
100101100000001111111111111000000000000110110111010100111101
110101100101110000011111111000000001110100110111010000000001
110101000000000000000000000001111111110000110110000000110001
1101010000000000000001111111D1111000000000110111111110110001
110100011111111111100000111100000000000000110000000000011101
100100011111111000000000000000000000000001100000000000001101
100100000000000000000001111111111011111111100000000000001101
110101111111100111111111111111111011111111100000111110001101
110101111111110111111111111000000011110001111110000000101101
110100000000110111111111110000000000000110000000000000000001
100001000000000011100000010000000010110101000000111111101101
10000001111101000000000000000000001001010101111011110D001101
100111111000011111111000111111111010110100011110111011101101
100111111111011111111000111111111010110100011110000000000001
111111111111111111111111111111111111111111111111111111111111
