111111111111111111111111111111111111111111111111111111111111
100111111111111111111111111111011111111000000000000000000001
100000000000000011111111111111010000000000001111111111111101
101111111111000000000000000001011111111011111111111100000101
101111111111111111011111111101011011111000001111111101111101
100111111111111111000111111100000011111011111101111001011101
101111111111110000000000000101111011111001100001111101000001
100011111111010111111111000000000000000000001101111101011101
111011000000010111111111101101111111110000000000000101000001
111001011111010111111111101101111111111000000000000000000001
111001010111010111111111101101111111111011111111111000000001
111000000000010100000000001100000111111010000000111100000011
111111111111010000111000000001101111111011111110111110111001
111011111000000000011100010111101111111011000000000100111101
111011100011111111111001110100001111111011011110111100111101
111011111011111111111101E10101001111111011010000111100011101
100011111000011110111100000101000000000011010111111100011101
100000000011111110111111111101011111111010000111111100011101
101000111011111110110000000001011111111010011000000000011101
110000000011111110111110000000000000000010000000000001011101
100011110011111110000000011111111111111010101111111100011101
101111110011111110000000011111111111111010000000111101011101
101111111011111110010000011111111111110000000000110101011101
101100001011110000010111111111111111110111000011100101011101
101101111001100111010000000001000001110111110011100001011101
101101111001100111010111111111111101100111110111101111011101
100001111001100111010000011111111100000111110111101111011101
111100001011100001011111011000001111100000010000000000010001
111101111010110101000000000110000000000110000001111111110111
111101011010110001000011111111111111110111111101111111110111
111101011000111100010000000000000011000111111101111111110111
111101000010000101001111000000011100011011111101111111110011
100000000000011100001111011111110110011001110100000001110011
100000000000010000001111011111110110111000000001111111110011
100110111111110111101111011000000110111001111101100000000011
100110111100000111001111011110100110000000111100000000010011
100110110000000111001111011110100111111110111100000001010111
100000011111100111001111000000100111111110000111101000000111
100000000000000000000000000000100111111110110000000000001111
111111111111111111111111111111111111111111111111111111111111
