111111111111111111111111111111111111111111111111111111111111
100000001111111111111111100000111100000000000000000000000011
101111111111100000011111101110111100111000000000000011111011
100000101000001111111111101110111110111111111111111111111011
100111101011110111111110001110000000111111111111111111011011
100000000000000110001110111110110001111111111100000000000011
101111000000000000101110100000111000000111111111111111011011
101100000001001111000000111000111000010100000000000000000011
100000111101001100000000111100111011110100011111110000001111
100000000000000000000011100000000000000100000111100111101111
110111111110111111110000000000111111111100111111000000101111
100001000000111111111111110111111011111100000000000000001111
100111100000111111011111110000111011000000111111111111000111
1111101111001D1111000011110000000001111110111100000000000001
111010000000111101010111111111100011111110111000011100000111
111000000000111101010111111111111010000000111000000000000111
100011101000000000010111111100000000000110000000000000010111
101000001001110000010000000000000000000000000000000000010111
101000000000000000010000000111111111111110000111000000010111
100000001111000000000000001111110000000000111101000101100111
100100000000000011110000001100000001100100111101001100000111
101000011111011000000000000000100001000100111101000000110111
100101011111011010000000000000101111100110111101111110110111
110101000001011010111111111011101000000110111101111000010011
110101000011011010000000010011100011100110111100000000010011
110001001111011010111111010011110011000110110000111011010011
101111000000000000010000010011110011000110110110100000010011
101111111111111111111111010010000011000110010100111100000011
101111111111111111111000010000000000000000000000000000000011
101000000000100000000010110111110101110001110011111111011011
101100000000000000001010110111110101110000000011111000000011
101001111111100000100010110000000101111111110011111000111111
101000000111111100000000000000000101111111110000011011111011
10100111111111110000111111111111010E111111110011111011111011
101001111111101100000000111111010001001111110111111000000001
101001111111100011111010111111010111101111110111110010000101
101000000001101011111010111111010000001000000111110011111101
100000011000001011011000000111010110100001110111110000100001
100001111000000011000000011111000110000000000111110000000001
111111111111111111111111111111111111111111111111111111111111
