111111111111111111111111111111111111111111111111111111111111
100000000001111111111111111111111111111111111111111111111111
101111111101111111111111111111111111111111111000011111000111
101111111101111111111111111111000000011111111011111111011111
101111111100001111111111111111011011111111111001101111011111
101111110000000000000111111111011011111111010001101100011111
101111110111110111110000111111011011111111010001101110011111
101111110000000111111111111111010011111101010111101110011111
10000000D011111111111111111111010011111101000000000000000111
111111000000000000000000000000010011111101111111111111110111
111111111111100000000001000111010011111101011111111000000111
111111111111111111111111011111010011110001011111111011111111
111111111111111101111111011110010011110000000111111011111111
110000000111011101111100011110000011111110011111111011111111
110111111111011101111111011110011111111110000011111011111111
110111111111011101111111011110011111111110000000111011111111
110111111111000001111111000000011111111111101110111011111001
110111111111011111111111111110011111111111100010111011111101
110110111111011110111111110000000000000011110110111011111101
110110111111011110111111111111111111101110000000111011111101
110110101111010110111111111111111111101110000000111010011101
110110000000010000000000000011111111101110110111111000011001
110110111110000001111111111011111111100000110111111000011011
11011011111011110111111D111011111111101110000000111000000001
110110111110000000001111111011111111101111111110111011111101
110110110000000111111111111011111111101111111110111011111101
100000111111110111111111111011111111101111111110111011100001
100000001111000111111111111011111111100000000110001011111111
101011110000000111111111111011110000001111111110111011111111
101011100000000011111111111011110011111111111110000011101111
101000001100000000000000000000000011111111111110111000000001
101111110101101011111111111110110000000111111110111111111111
101111110100001011111111111110000011110110000010111111111111
101111110100000001111111111110001000000000000000111111111111
101111110000000000111110000000011011111111110111111110000001
1000000001111111101E1110000010011011111111110110000001111101
111111000000000000000000110111011011111111110000001111111101
111111011111111111111111110000000011111111110011101111111101
111111000000000000000000000000000011111111110011100000000001
111111111111111111111111111111111111111111111111111111111111
