111111111111111111111111111111111111111111111111111111111111
100111100001111111111111111111111111000000000000011111110001
110111101000000011010111111100000000000011111000011111110101
110111100111111000000000011101111101000101111000000000000001
110111100111111000111111110101111101011101111110000011000111
100000000000000000110111110101111101000101111111111011110E11
100001111110011100100000010101111101110100000111111011100111
101110000000011100100011110101111000000101111111111011110111
100000000000011100100111100001111001110101111110000011110111
101111110000011100100000000000111001110000011110100000000111
101111111110011100101111111111111001110111111110101101100111
101111000100000000000000000111111000010111111110000000000111
101111011100000111111000000011111011000000111100000001110111
101111011100100111111111111000011011110000000000011101110111
101111000000100111111101111001011011110110100000000001110011
101111111000100111000000011001011011000110000011000001110011
100000000001100111000000011111011011010110000000000001110011
100111111111100110001111011111011001000110011110000101110011
100001100000000110101111000000000000000000001111110101110001
100111100101110110100000001111000000011111111111000101000001
100111000101110000000011001111011111111000000111110100111001
100111000100000000000000001110011111111000000000000101111101
100100000000000100000111101110001011111000000000000000001101
100100000011111001111110100111100000000000010001100001001101
100000000000011000111110101111101011111110110101101111101101
100000000011010000000010101111000011111110110100000000000101
100000000000011111111010101101111000000110110000101111111101
101011111111111111111010101101111000111110110110101111111001
101000000110001101111010100101101000000000000110100000111001
100000000000000100011010101101101111101111110000000000000001
100101110111000001111010101101101111101111111000001010000001
100100000111011001111010101101101111001111001111101010000001
100101111111011001100010001100000000000000000001101000000001
100001000000000001100000011100000011111110001111100011011101
100100000000000100001110000000011011100000001111011000011101
100111011111111111101111001100000000000000000000001011011101
100111011011111111100111101111110000000000001111000011011101
100111011011110000000000101111110111111111101101011111011101
100000011000000000000111100000000000000000001100011111000001
111111111111111111111111111111111111111111111111111111111111
