111111111111111111111111111111111111111111111111111111111111
111111111111111111000000000000000000000111111111111100011111
100000000111111111111011000001100011100000100000001111011111
101111111111111000000011110101101111110110111111101111011111
101000000000000111111111110001101110000110000000001111011111
101011111011111111111110000000000001110111111000000001001111
101011111011110000001111111111111101110110000001111101011111
100000111011110111101110111111111100010110111111111101001111
101110000011110111001010111111111111010010110000110001010111
101110111D00000111101010111111111111010000000000000001010111
101110101111100111001010111111100000010110000111110101010111
101100101111100111011000000000000000000110110111110101000111
101110101100000000011011111111111111100110010111100101001111
100010000000000000011011111011111100000110000000000100001111
111000000111111111011011111011100001100110101111110001000001
111011111111000001000011111011101111100110001111111111011101
111011111111111101011011000011101111000111111111111000011101
111011111111110000011011111000000000010000000011111111011101
110001111111110000011011111011111111010111111111111111000101
111100000000000100011011111011111111000000111000000000010101
100001100010110110000000011011111111001110011011111111110101
111111111010110110000011100000000000001110011000000000000101
111111000000110000001011100001100000001110000001111111110001
100001111110110000000000000000000000111100000000000000000011
101101111100000011111000000000011110000000000000111111010011
101101000000110000000000001111111110100000000000000000010011
101100011000110000000001111110111110111E10000001111111000011
101101111100111111000000111110111110111111111101111111110011
100000111100011000000000001110111010011111111101111111110011
101110111100011111111001111110111000011100000001000001110011
100000000000000000000000000000000011011100111100000011110011
101111111111111111111111111111111111011101111101111011110011
100011100000111000111111111111111000011101111100000000010011
100000001100111011111101110111111011000001111111111111110001
111111111110000000000101110111111001001111111111111111110001
111111111110111111101101100110000001001111111100000000000111
111101111100111111101101110111111001000000000011011111111111
100000000000111111101101110000111001000111000000000001111111
101111111111111111100000000011111000000000011111111100000001
111111111111111111111111111111111111111111111111111111111111
