111111111111111111111111111111111111111111111111111111111111
100111111101111111111100011111000000000001110111111111111111
100000000000000000111100000011011111100101110111111011111111
100000010111111111000000000111010111000101110000110000000001
111111010110000011011111111111010111101101000100000000111101
11111101000000000001111111111E000000001101111111111000000001
111111000000111111111111100001100000001101101111111111011101
111100000000111111111111111001000011000001101100000111000001
101000000000111000000011111001001111001111100111100000000001
101000001110111011110111111001001111001110000000110110000001
100110000000011000000000000000001111001110000000110110111111
100111111100111100000111111111111111001010111011110010111111
100111110000000000000000111111111100001000111010000010000111
100111110101111011111111000000000001111000000000110010111111
100011110000011010000000011101111001111000000100000110001111
101011000000000000000000001100111000111000111101110110111111
101011111110111111110111101100111000000000010000100110111111
100000000000011111110111101110110011000000111101100110101111
110000000000110111100000000000010010000000011101101110101111
110111000000110111101111111111010011111110111101101110101111
100000000000110111100000000000000000000000000000000000001111
101110000000110111100011011111111100000111111101000011001111
101010000000110111100000011111111000001100111000000011000001
101010110111110111100011111111111101111100111000111111001101
101010110100110001101111111100001101000100111000111100001101
101000110100000001100000001000000000000000111000011100001101
101000110100111101100000001111000000001000111011011011100001
101000110000000000001111110111011101111000111001011010111101
100000111000000001111000000111011101001000111001011000111101
101000011000000001111111110000000000000000111001011000110001
101010011011000001111111110110111111111000011001011110111101
100000001011111101111111110100111110111000000000011110111101
100111101011111101111111100110111110111110001111111110110001
110111101011111101000000000000000000000000111011111110001001
110111101011011101011111111000000100011111111011111110001101
100000000010011100011111111011110101111100000000011110111101
111100000000000001000000000011110101111101111111100000000001
111111111110110001010000011011110101111100000000001111000001
111111111110111100000000000011110000111111111111001111111101
111111111111111111111111111111111111111111111111111111111111
