111111111111111111111111111111111111111111111111111111111111
111101111111111111101111111111110111110000011100000000000111
100001111111111111101111111111110111110110011110000000000111
100000000000000000001110000111110D00000000011110110111110111
111000111111111111000000111111110111100110111110110111110111
10100011111111110000011011111111011111D110111110110111110111
1010111111111110011111101111111101111100D0001000000111110001
100011111111111001011000111111110111110111001111110100D00101
1010111111111110010111100011111101111100110010000001D1111101
1010000111111110110000D0001111110100D00011001111110100110001
101011111111111011111111000000000111111011001011010100000001
1000001111111110111111111000000000D0001011000001010100100001
110000000001111001111111101111101111100000000011010000111101
1101111111011111011100000011100011111001111100010111100D0101
110111111101110D000D0101001111100000000111110011011110110101
110111111101000111110101001111110000000000010011011000S10001
110111111100000001110001001111110011111111110011001110100001
100000000000001111110111001111110010000000000011101110001101
100000001111100000000001001111110000000001110011001110111101
100011101111100000001101101110100111111111110011100110000001
101011101110110000000000000000000111111111110000100111111101
101011101110110111111111011110111111111111000110000111110101
101011101110110011111111010000111100111110000000111111110101
10000000D000100000000000010000111101111011110010111111110001
100111111110110000011111010000111101111011110000011100000001
100111110010110000001100000000111101000000000001011000000001
100111110000110000000000000000111101011111111101011000001101
100111110000010111111111000000000000011111011101010000001101
100000000010000111111111011111111111111111000001000000000001
111111111111111111111111111111111111111111111111111111111111
