111111111111111111111111111111111111111111111111111111111111
111111111110000000000000011111111111111110000000000011111111
111111101100000000100001010111111111111110111110000011111111
111111101101000110000000010111111111111110110000000010000111
100000001101111110001101110111111110000000111111110010111111
111111101000000010001101100111111110110000110111110010011111
111111101100001010001101100111100000000000110111110010110111
111111101111111010001000000111101110000000000000000010000011
111111100000000010000000000000000000000000000000000000011111
111111101110000000111100001111100000001111111111110111111011
111000001110111111111100001111000000000000000000000000000011
111110111100000000000000001111001111100000000011110010000001
111100111100111110100001001111001111100011111111110011011101
110000000000111110111100000111001111100000000000000011011101
100100000111111110000000000111001111100001011111110001011101
100000000000001111011111110111000111100001011011000000011101
111110110000000000011111100111001111100001010000000000000001
111110100000001111111111100111001111100001010111111110011111
111110111100000000D00000000000001111100000010000001110010111
111110111101111110111111111011100000001100000000111110000001
10000000000111111010D000111000000000000000000000000000000001
101111111100000000101000000000011101111111111111111111100001
100101111000111110100001111111011101111111111111000111101111
100000000000100000101000000000000000000000111111110110001111
100000000000101110001010000000000000000011000000010110101111
100011111001100110111011111111111111101000110111110110001011
100001000001100000011010000111101111101011110011010100000011
100000000101100110000000111111101111101010000010010000000001
100110000001100110111011111111101111101011110010000111111111
110000000101100000101010000000000111101011110010011111111111
110111110100000110101000000000011111101011110010000011111111
110111110001111010101011111100000111101011100010000000001111
110111110101011010001011111101110000001000000000000011111111
110111110001010000110011110000000111001111100000001111111111
100111110100000000000000000100000111000000000000000111111111
1001111101111110000001111E0000000011101110000000000001111111
100000110111111111110111110111111110000001111110011111111111
100111110111000000000110000000001111101011111110011111111111
100111110111111111000000000111100000000011111110011111111111
111111111111111111111111111111111111111111111111111111111111
