111111111111111111111111111111111111111111111111111111111111
100000000011111111111110000001110000000000011111111111101111
100100000000000111011110111101110101111111L10000000000101111
100010111111110111011110001101110101111111110111111110100111
100010001111000111011110001001100000000000000001011110101001
101010011111110111D11110101001101111100011111101011110100001
111D10111111110111011110101001101111100011001101000110101101
111010011111110001011110001001100001100000011101010110100101
110010111111010000000000000001000011100001011101010110110101
110000111111011110000001000001001111100001011100000010110101
11110011111100001111110101110100111100000D001100111100110101
100100111100001011111100000001001000000001001111111100110001
1011001000111D1011111100001111000000000001100011011100111101
100000111D11101011111100001000001111100001101111011100111101
100000111011101000000000001111101000000001101111011100001101
1110000000111D1101000000001111101011111001101111001111100001
111011100010000000000001001111101010000000100111001111100011
11101111000000001111100D00111110000000000010000D000000101111
111011110111011000000011101111111111111000100011111110101111
111011110011011000000011101111111110111000101111111110101111
1110111100000100000000101011110111101110001011111111101D1111
111001111111010011111010101100011110000000101111111110101111
1110111011110000111110101011100110D00100001000D0111110001101
111011101110000000000010101110111111010000000010011110101101
1110011011001100000001101000000000D0000001111110111110101101
111011101100110111110110110101111110000000000010111110101001
111011100100110011110110110101111100000010111100111110100001
111010000000000000000000110100000000000000001100111110101111
111011111001111111111110000001111111111111111100000000101111
111111111111111111111111111111111111111111111111111111111111
