111111111111111111111111111111111111111111111111111111111111
111111111111111111111111111111111111111111111111111111111111
111111111111111111111111100000000111111111111111111111111111
111000000011111111110000000100000000000011110111111111111111
101111110011111111111111100000011111110000000111111100000001
101111110011111111111111101111111011000001100111100011111101
101111110010111111101111101111100001111001100111101111111101
100000010010110000000000000000000001111001100000001111111101
101111110000110111100000001111111111100001100000000000000001
100000000110000111101111111111111110111001011000000000011101
111000000110110000000011111110000010110001011100000000000001
111100000010111011111111111110000010110001011100000000011111
111101111000111011111111111111111010110000000000000011111111
100001100011111011111111111111111010110000110000000011111111
100011111011111000001111111000001000000000111111111011111111
111011111000001011111111111111000000000000111111111000000111
111010110011101001111111111111001111111000111111111011111111
111010111011100001000000000000001111111000111111011011111111
111010111011000000011111111111111111111000001111011011111111
111010100000011111011111111111111111011000001111011001111101
111010000000000000011111111111011111000000000000011010000001
111010001111100000011100000000000000000000000000000010111101
111010000011111111111111000001100001111111111000000000111101
111000000011110111111111011101111111111111111000011110011101
111000100010000000001100010000000000111111011011011110011101
111110101010111111101000000001110011110000011011000110000001
111110000010111111101011111100000001111100000000110000010001
111110101110100001000000000000000001111111111110100110011101
111110100010110011101111111111111111111111101110001110000001
111110111010110001100000111111111111111111101111000100000001
100000000010110001101111111111111000111111101111000101111111
100000000000000000001111111011111000000000000000000100011111
101110000111111001100000000000111011111111100000000001111111
101110000000000000101000001110111000000000001111110000000001
100000111110000000000000000000111000000000011111110011000011
101110000001111110000111111111111001100000001111110011011111
10111011110000011000000100000001100000000000000000001101E111
101110000000111110111111011111111011111111110111100000000001
100000000000000000000000000000001011111111110111111111111101
111111111111111111111111111111111111111111111111111111111111
