111111111111111111111111111111111111111111111111111111111111
111111111111111111110000000000000000000000000000000000000111
111111111111111111110111111110000000000000001111001111111001
111111111100000111110001111000000000011111001111001111111001
111111111100000000000011111011111111111111000000000000011001
111111111101111111011000001011111111100011011011000000011001
101111111101111111011001101011111110001011011001000100011001
101111111101110111010000001001111111101011011000010000010001
10111111D100000000000001001011011111001011000000010100010001
101111111101111111111101101011011111101011111100000001010101
101110110001111111111101101000000000000011111011111111000001
101110111100000011111000101101110000111111111011111111110001
100110110000001110111000100000011100011100000011111110000001
110000001110001110111000101101000000011111111000000111111111
111101100000001110000000101101101100000000000000000000011111
100001111111101110000000000001100000000000000000011011111111
101101111011101000101111101111011111011110111111111010000111
101101100011101110101111101111000000000010111110000011110111
100001111011100010101011101111000111111000111110111000010111
111101111011001010101011101111000000000010110000000000010111
10000000001100101010101E101111001110000000011101010001010111
111111111011001010101010000000001111100111111101010001000111
111011111000000010100000000001111111100001111101010001110111
111011111011010000111001111011111111100111111100010001110111
111010000011011000111001111011111111000001110000000000000111
100011111011011000111000001000111111111101111111111011110111
101111000011011010111011101111111011111100000001111011110111
100000000011001010000000001000011011100000010110111011110111
101111111111101010111111111011111011101100010110110000010111
101111111111101010111111101000011011101111010110110111110001
100000000111001010000000101111011011100001000110110111000001
101111111111100000111110100000010011101111000110110111111101
101111111111101110111000100101000011101101110110100111000001
100000001110101110111000000101110111100001110110100111111001
101111000000101110111110110101110110001100000000000111111101
101111000011101110010010110001000111101111111111001111011101
101100000011100000010110111111110000000100011111001111010001
101101111111101000010110000000000000000101001111000000010111
101101111111100000000111111100000000000000001111011111000111
111111111111111111111111111111111111111111111111111111111111
