111111111111111111111111111111111111111111111111111111111111
110000000000000000000000000010001111110000000000011111111111
110111111100000001101111111110001111011111111111011111111111
110100000000011101101111111110001111011000000000000111101111
110100000000001100101111111010001111011011111111110111101111
100000010000001100101111111010101111011011111011100111101111
101111110000111000101111111010101100011000000011100110101111
101111110111111000101111111010000001000000001111100110100001
100000000111111000101111111010111101111110000000000100011101
110111110D01110000101111111010101100000000000111100101100001
100111110111111110101000000010101101111111100000000101111101
100110000111111110101111111010000000001111101111100101111101
100100111111111110101111111000000001111111101111100101111101
100100100000111110101111011111111101011111100011110101100001
10000010000000D000101111011100000000000000001111110101111101
100000101011111100101111000101111111111111111111110101111101
111110101011111100101111011100001111110000000111110000000001
110010100000000100001111011111101110000111111011000000001101
110000000111111101101111011110001111110111111000000000000001
100000100000000000000000000010101111110111111001111111111101
100100100000001011111111100000101111110111111001110000000001
100000111100000011100000111011100000000000000000000000001101
101010000000000000100001111011110101100111111111011111101101
101000111111111010111101111011110101100110000000011111101101
101000110111101010000000110000000100000110000000000001100001
101010110111101011111111111111110101110110000000011110101101
101010110000001011111111100000000100000111111111000010101001
100000111111101011111111100000000000000111111111011100101101
111111111111100011111110111111111111000000111111011100101101
111111111111101111111110110110111111000011111111011101101101
111101000000000000001110100000000000000000000000000000001101
100001010111111111111100111110000000000000100100001111101101
101100010000111111110000110110E01111000111100101111011101101
101101010111110000000100110110101111000000001101111000001001
101000010111111111111110110100000000000011101100011011101001
100100000100000001111110110100000001111011101100000000101111
101100000000000101111110000000100000011000001101111110101111
101111111111110101111111100010100111011111110101011110101111
101111111111110000001111100000100111000000000000000000001111
111111111111111111111111111111111111111111111111111111111111
