111111111111111111111111111111111111111111111111111111111111
111111111111110000000000000000010011111110111110000000000001
111111111111011111111111011111010000000000111110111101110101
100000000000000000001110000000000000000000000000111101110101
101011110111110001001110001111111000000001100000000000000001
100000110000000001001000101101101111111111101111011111110011
111011010111110000000000001101101100000000001111000000010111
111011010000000011110111101101101111011100001100000111110111
111011010011111111110001101101101000000000000000000000110111
100011010011111101110110100000000000001100011111111111110001
101011010011101101110110111100000000000000000000000000110111
101000000001101101110110011101011100000111011111100000000111
100011100000101101110000011101011100000000011110111110110111
1000000011000DE001111111011101011101110100010000111110110111
101000111100000001111111000001000000000101100010111000000111
101000000000000000000000000000011110111101101110111011110111
101110001111111111111111110000000110100000101110100000000001
100000000000000000000000000000110110101100101100000000000001
100000110111000000011111110110110000000000101100000001111101
1011011001110100001D0000000000110000011100100001000100000001
101101110111011110110111111111011000000000000000010000111101
100000000001011100110111011111011000000001111100110000111101
111101111101000001100111011111000000000101110000000000000101
11110000000111000000011D011111001100000001111111111111110001
111111111111110110110110000000000000001111111111000000000001
110001111111110010110000000111100001111111000000000011110001
110111111100000000000001111111111100001111111011111110000001
110111010000000001100000000001111111000000000011111111110111
110111000000111111100110000000000011000100000000000000000001
110000000000000000000111110001001000000000111111111111011101
111001111110000011100111110001001001101100000111111111010001
111001111110111111100000000000000001101100111111110000000111
100000000100000000000011111000001111100000000011111111110111
101110011110000000101100001111100000000011010000000010000111
100010011110111110001111101111100000001111010000000010110001
111100011110000111100000101100100111101000010111111110110101
111110000000111111111110001110101111001111000011111110100101
111111111000000000001111101110000000000000000011011110000001
111111111011111111111111100000000000000111110000011111000111
111111111111111111111111111111111111111111111111111111111111
