111111111111111111111111111111111111111111111111111111111111
111111101000000111111111111111111111111011111110000000111111
100000000001100111100001111111111111111011111110000000011111
111101111111100111111101111111111111111011111110111111011111
100001111111100000000001111111111110111000000000001111011111
101001111111111111111101111110000000110000000110000000001111
101000000000000011111101111110111100000000000001111111001111
101001101011000011111101000010101100111111111100000111000111
100001101011010011111101111010101000000000011101110111000111
110001101000000001000000001010101011111101011101110111000111
111101101111111110100000001010101011111101011101110101000111
111101100000000000101111000000001000000001000000000101000001
100001001100000000001000000111111001111101001101111101000001
101111101111111111100000101000111001111101001101101101001101
100000001111111111101110101010100000111101011101101101001101
100111111111111111100000100010111000000101011101100001000001
100111111111111110111111101110000000000100011101100000001101
100111111111100000000001101110000001111100000000000111111101
100111111111111111101000000000000000000000001111111111111101
100011111011111111101011000001111100010000000000000111111101
100011111000111111101011001111111100000000011110000000000001
100000011000000000000011001000000000000011111110011011111101
100111111111111111111011000011111111111011111110111011111101
110000000001111011111000001011111111111000000010000011111101
101111111101111010000000001011111111111111100000111011111101
101111111101111000000000001011111110111111111110111011100001
1011111111011110111E1111001000001110101100000000111011111001
101111111100000000000111001011101000000000000000001000000001
101111111111111100000000000010001110110000000011110011111101
101000000111111100000011000010101110111111111000011011100001
101111110000100001111011000110101000111111111111111011111111
101111100000011100000011000010101100000000000000000010000011
101100010001000001111111000010001101100000011111111011111011
100101110001111100000000001000000100000111110000111011111011
100101000001111101111111111001100100001100000011111011111011
100000000001111101111101111001110100000000000011011000111011
101011111111101001111101101001110111111111111011011000000011
101001111111000001100000001001100111111111110000000000111001
100001111111000000000000001001110111111111110000000111111111
111111111111111111111111111111111111111111111111111111111111
