111111111111111111111111111111111111111111111111111111111111
101111000001110001000000000101111111001111111110011111111111
101111010001111100010000000100000001001011111110001000001111
101111000001000000000000000000000000000000000110010000001111
100000001000000000000000000011011111101000000000011111100111
100000011111110111000000000011011111101111111111011111000111
101100000000110111011110001111000000000111111111011011010111
100001110000000000000000001111001111000111110111000000010111
111111111101111100000110101111000000000111110110000000000111
110111000000000000000110101111000000000111110110000000010111
110111111110101000000110101111011111011111100010000111010111
110100001110100000110110101111000011011000000000111111010111
11011000111010111010011000011101001101E110111110111111000011
110110111110101110100110000000000010000010111110000000000011
100110000000001110100110000111010000000000000000010000000011
110100000111101110000110000111010000000001100000000000000011
100101101100000000010110000111010010001001100000011111111011
110100000000100001010110000111000011101001111111111000000011
110001101110101111010000000111011011101000110000010001110011
110101101110100000000000000111001011101000000111011101111001
110101100000000111111000000000011011101001100001011100000001
110101101111000111011000000000000011000011100001011101000001
110101100011000001001111111111111111000011100111000000011101
110100000000000111001100000000000001011111110000011111000001
100000000011110000001111000001111001011111111111011111111111
100111111000000100011101111101111001011111111111011101111111
100000011011110101100001111101111001000000000000000000000011
100111111010110101111101111101111000011000000000011111111111
100111100010110001001100000001111011011110100001000000000011
100111101110000110000000011101110001011110100000000000000111
100111101111100111001111011101110110011110100111000000000001
100000000000000000001111011101110110011000100111111111111111
101101111111110000000001011101010110011110000000000000011111
100001100000000000001111000001010110011111011100000011111111
111101110000000000001111011111010000010111011100111000001111
101001111111110000100011010000000010010111011000000000001111
100001011110000000011000010011111110010110000000010000000111
110001011111110000111011110000000000000000011110011001111111
110000000000000000111000000000000000000000000000000011111111
111111111111111111111111111111111111111111111111111111111111
