111111111111111111111111111111111111111111111111111111111111
111111110000000000000001111011000000000000111111011110000011
100011111111111110111111101000010110000000000111000011011011
101111100000000000111111100000000111110000000000001111000011
101111111111110100111111100000000011110001111111101000000001
101111111110000100000000100000011111110000001011100000000001
101111101111110000000000000000000000000000000011100111111101
100111101111111000010111011111111111110011111011100111111101
11000000000001000000011100000001111111001111E011100111110101
111111111110000101100111100000010000010011111010000000010101
101000111111110100000111110000011111010011111011100111110101
101011111111110000000000110000000000010000000000000111110101
101000000000000001111100000111111111111111111111110111110101
101011100000011101111101110100011111110000000000000000000101
101000001100011101111000000111011111110000000000111111101101
101111101101011101111001010000000000000111011111000000000101
100001100101011101100001011111110000000100011111000011111101
101111100000011100001000000000000000000011111110000011111101
101011100010001100000000000000001100011111111110000001111101
101011111010001101101100111111111100000000001010111111111101
101011100010000001101100111111101110111111111000111110000001
101000001110001100001110111100000000001111111010111111110111
101011101110001111000110111101111000001111111010000000000111
101011100000000011000110111101111000111111111010111111110111
101000001111001010000110100001111011111110000010111111110111
100001101011001010000000110000000000000001110010111110110111
10111110000000101001111000D000010111111100000000000000000001
101111101111100010011111100000010111111111111111111111000001
100001100000010000011000101111110111111111111111111111111101
101111101111000000011000000000000000000000000001111011111101
100111101111000000000011011110000001111011110001111001111101
110111101100000000000000000000100011111000000111111001111101
110111101111111100111100000011111011111111110000000000000001
100111101111111100000000000000000000001111110100000111111111
101111101111100000011111000000000000111110000001100111000001
101111100000011100001100011110000000000110110110000111110101
100000001111011111101100000000011011110000000000000000000101
111111001111011110100000000000011011111111100000000111100101
111111000000000000101111111111000011111111111111000111100001
111111111111111111111111111111111111111111111111111111111111
