111111111111111111111111111111111111111111111111111111111111
111000001111111111111111111111111110111111111111111000000001
111111101111111111111110000000111110111111111111111011111001
111111100000000000001111111110111110110000111111111011110111
111111100000000000000111111110111110111000111111111000000011
100011111101100000000011111110111110111011111111111011111111
101111111101111111110111110000000000000000000000000011111111
101111111101110000000101110000000000110000000000101111111111
101111111101110000110101110000000010000000111111101110000001
101111111101110000010001111111111000000000111111100000000101
101111111101111111110000001011111001111100111100000000000101
101111111101111111111111101011101001111110011101111111000101
101111110100000011111111100000101001111110011100000001111101
101111110111111000000011101110101001111110011111111100000001
101111110111111011111111001110101001111110000000000000000001
101111110111101001111111001110101001111110110111111000010101
100000000111101101111111000000101000000000000000000000000001
100111111111100001111111011110101011111000000000111111111111
1001111111111011100111000111000010000000E1000000000100000111
100111111111101110011111011101100011111111111111110001110111
100000000111101110000000000000111011111111111111110111110111
111111101111101110111100000000111000111111111111110111110011
111111101111101110111111111110111011111111111111110111110111
111111101111101110000000000000100011111111111111110111110111
111111101111101110001111D11110000000000000000001110111110001
1111111011100011100000000D1111011010000001111111110111110101
100000000000000000000011100001011000000000000000000111110101
111111111111110000000000000000011100001111111111111111110001
101111110000000000000011110111011111111111111111111111110111
101111110111110111111011110111000010111110001111111111110111
101111110111110111111011110111000000000000000001111011110111
100001110111110000000000000011011111111111111111111011110111
10110111000000000011111111101101D111111111111110000000110001
100001111111111111111111111011011111111111111110111110000001
100000000000000000000000001011011100000111111110111100011101
101111000000000111111111101011011111110111111110111100011101
101111010111000001111111101011011111100000000000101101110101
101111010111111101111111101011011111101111111110001101110101
101111000111111100000000000011011111101111111000001100000001
111111111111111111111111111111111111111111111111111111111111
