111111111111111111111111111111111111111111111111111111111111
100001111111111111111111111111000000000000000000000110000001
101100000000001111111110000000011111111111100111110100000001
101100000000000001111111000000000000111111100111110111101111
100000000000001110101111111111101110111111100111110111001111
101100000000110110101111111111101000111111100111110000000111
101111111110110000101111111111101111111111110111111011100111
100000000000000110100000000100000000000000000111111010000111
100001110000000010000000000000000000000101110111110010000111
101110110101110000000000111111111100000001110111111010010111
100000000000000000000000011011000000010101110111111010010111
101110111111000000000011111000001100010100000110111010000111
101110111111111111110000001011111001000111110110111010000001
101110111100000000000101101001111000010011110000000011111101
101110111111110000000000001011111001010100000100000000000001
101110111111111111110011000000000001000111110000000000010111
100000111111111100000000000000000111110000000111111111110111
100000111000011111100000000000110111111110000000000000000111
101110011011111111100000000011110111011110000111100000000001
101000011001111000000000000000000011000001110111111101110111
101110000000100011111111100000100000000000000000000001110111
111110111000011000000011101111100000000011111111111001110111
111110111110011000001111101111100111000111111111111001110001
100000111110000000001111001111100000000111111111110000000111
101110111110011111100000001111100011111111111100000000100111
101110111110000111111111101111100011111100000001010000100111
100110111110011101110000100000000000000101000001010000100111
1001101111100111000001111000011100011111000000110E0100100111
100110000000000000000000000000110000000000000000000000000111
100111110101100011100000001110000001110000000111111110110001
100110000101101111101011111110111100110011000000000000011101
101100000001101111100000111000000101110011111111000110011101
101111111000000000000000111000110100110000000011011110000001
101110111011111011000000000011010100110111111100000010000001
101110101011111000011101111011010100110111110111011011111111
100000000000000001011100000000010100000111110111011000001111
101111111001010111011100011110010101110111110111010111011111
101111111000010111011100001000000001110000000110000000000111
100000000011000111000001111111111100000000000000000000000111
111111111111111111111111111111111111111111111111111111111111
