111111111111111111111111111111111111111111111111111111111111
111111110111111111101111100000001001111111111101110011111111
111111000111111111101111101111101001111000001101010010000001
100000000111110000001111000000001000111111001001010000111111
101110110100000000011111011110111001111111011101010111100001
101010110101111111011000010010111001011100011101010111000001
100010000000000000011000000110011001011111011101000111111101
101000000110000000000011110010000000001111000000000000001101
100000000000000000000011010010001110001111011111110110001101
100011000000001111111011010010101110111111011111110111001101
100011011111111011111000010000000000111111010000000111001101
100011011111111010000011010011101111111111011111110110000001
100011000000000000011011010000000000000011011111100011101101
101000000111011100010011010111110000000001000001100111101101
100000000000011100010011010100000111000000001100000111100101
100011111111111000010000000000000000000000100011000111100001
100011111110110000000000001010111111111011111011000000011011
100011010000001110000111111010000000000000000010000000000011
111111011111101110000000111010100000111100000000000000011111
111111011111101110001010111000101110000000100000000000011111
111111011111100000001000000011100000000111101111111111111111
111110000000101110000000011111100000110111101111000000000011
111110000111101100111111111111100010110011101111011110000001
111100000000101E01111100000000001000000011101110000000111101
111101111110101101100000000000000011100011100001111111110001
111101111110100001111100111100011011100011101111111111110111
111101111110100110000000111110011011100000001000000111110001
111100000000000110111110111110011011000011100011110111111101
111100101111110110111110111000000000000000000000000100011101
111100101111110110000110110000111111000010111111011111000101
111100101001110110000000110011111111000010111111011111000001
111100101001100110011110110011111111000000000011011111000001
111100100001100110011100110000011111000010000001001111001111
111100100001100000000000000010111111000011111101000000101111
100000100000000000011110111010111100000000000000011110101111
100000100000000000000110110010111100001111000001000000000001
100001100000111111111110110010111100000000000001000000000101
101111100000000001100000000000000000011111111101011100001101
101111100000000011111110000111111111111111000001011100000001
111111111111111111111111111111111111111111111111111111111111
