111111111111111111111111111111111111111111111111111111111111
111111110000000000000000000011111111110000011011011111111111
111000001111111111111100000011111111110000010000011000001111
100011111111111111111100110000011111111111001000011010111111
100000000011111111000000000000000000000000000011000000011111
101111110000000111111100000111111111111111111011000000000011
101101100000000010100001000000000000000000011000000111011111
101101101111110000000010000000000011111011001011100110011111
100001101111111111011010000000000001111011011011110100011111
111110001111111111000000000111011100000011011000010111011111
111111101111111111010000000011011100000001011001110110011011
111011101111111100010000011011011100000001011001110000011011
100011101111111111111111111011011101110001000001110110001011
101001101111111111111100011011011101110000000001110110011011
1000010000000000000111110110110000000001111111000001100E1011
100001111000000111010000000011100000111111111100110011000011
100001100000000000011111100011011110111111100000110011011001
100000000011111101111100001111011010000000000000110000011111
100000010000011000001101111111000001111111101110110000000011
100011111101111100000000111101111101110111101110000001111111
101011110101111101111100000000011100000000000000011101111111
101011110101111101111101111111100001111100000000011101111111
101000010101111100000000000000001111111111101111011101111111
101111000100111101111111111000000000000000100000011100111111
101100000100110001111000110111111111101110101110011110011111
101111110000111100011011000000000111100000001110011110011111
101111110100111111011011111111110111111000111110011110011111
100000000000000000000000000000000111111110110000000000000001
111111111111111111011000000000011111111110111110010111111111
100000000000000000011011111111011111011110000100010011111111
111111111111111111011010000011011111010000000000010111111111
100000111111111000011000111011011111011110110000010111110001
100110000000000101000000000011011111011110111100010111111101
100001111111110100000111111111011111011110111100010111111101
100000000000000111110111111110011111011110000000010111111001
111011101111100000000111111110011111011000000000010111111001
111011101111100111111111100000000000000000011110010000000001
111011101000000101111111101110001110111111111110010111111101
111000000011110000000011100000000000111111111110000111100001
111111111111111111111111111111111111111111111111111111111111
