111111111111111111111111111111111111111111111111111111111111
100000000111111111111110000000000000000000001111011111111111
101000011111111000111110000000000000111111101101011000000111
101110000000000000000001111111111010111100001001000000111111
100000100000000000000000000000000000000000100100011110000001
100110111110000111111111111111000000111111100111000000000001
100E10111110111011111100000001111110000111110011111111101111
100110000000000000000001100011111010011111110011111111100001
111100111111010000011101101011000010011110000001111111100101
111110000000010111111101101000000010011111111101111111100101
111111000000010110111101101111110010000000011101111101100101
111111000001110000111000000000110010111111011101111101100101
111111010111100100000000000000000110111111011101000001100101
110111010111100100110000000000000000000000010001010111100001
110111010110000000110110100011110110100000000000000100000101
110111010110111000000110011111110110100000001111100000000101
100111010110111111110110111111000010111110000000000000000001
100000000010111111000110111111110110111110000000000000011111
100000000000000000000110111111110000011110111111100111011111
110000000000011111110000000000000000000110111111100111011111
110101111011001111000000011111101111110110111111101110011111
110000111010000011111011000000001000000000100111100100011111
111100000000100000011011011111101111110110000000000111111111
100000000110111100001001001100000001110000000000000111111111
111100000000111111101001000001111100111101101000010110000011
111110111100000000001001111100000000000001101010000111111011
101110011010000000000000000001111100011101101000000000011011
101110111010000001111111111101111100000001101111110000000011
100010111011111101100011111100011101000000000110000111111111
111010111010000001100000000001110100000000000000110111111111
100010101010000111100111110111110110111110000010110001111111
100110101011110111100000000000000100111110101110000100000001
100000101011110111101111000001100000111110100000000000000101
101111101001110111100000111001111111100000001111111111110101
101111101011110000001111111000000011000000000000000000010111
101100100000000111100000000000111100000000000000111111010111
101100100000000000000000111100000000000000000000000000010011
101100110000000111111000000000011100000011001110100000000011
100000000000000000000011111111111111111000001110000000000011
111111111111111111111111111111111111111111111111111111111111
