111111111111111111111111111111111111111111111111111111111111
111100000000011111110000111111110111111111111110000000000001
111111111101111111110011111110000000000111111000000000111101
110111111101111111111000000011110001110100000000000000111101
110000000000000011111110111000011101110000111111110000111101
100111111111111011111110110001111100000111111111111100111101
101111111111110011111110110101011111111111111111111100111101
101100000000000111111110110101011110000000000000000100111101
101111111000000001111110110100000000011111111111110000111001
101111111111111100001110110000000000001111111110001100111001
1011101000001111011011100101111111111111110111101E1100111001
100000000000001100001110110000000000011100000100000000011001
101111111000000000111110110000111111111111110000000000001001
101111110111111110111000000000111111111111110110111111111001
101111110111011100000011111010111011111111110110111111111001
100000000111011110111111110000011011111110000010111000011011
100000000010000010101111110111111001011111100110111011111011
100110111111111010101111110100000001011101100110100000011011
100100111110111010000111110000110001011101101110111110011011
100100000000011010100011110000000000001101101110111110011011
100100111111111010100000000100000000000001101110111110011011
111100000000000000100111110101111000001101101110111000000001
100000011101111110000000000101110111011101101110111011101111
100000001100111110000000000100000110011101101000000000001111
111111101000111110000111110111100100011000000000000100000001
111111000000111110000111110101100100001011111111100000001101
100000000000111110000000000101100100001000000001110000000001
101110111111111110011111111101100100000010100000000000000001
101110111111111010000000000000000011101110100000001111111111
100000110111111011111111101100001001101000011110100000000111
100000000011111011111111101111101011100000111110100101111111
101111111011011011101111101000001011100100100000000101000001
100000001011011000100010000000001001100100000110100101001001
111111100000000000000111100000100011100111111110100101001101
111111110111101111100110000000001000000111111110100101001101
100011110011100000000111100001100011111111111100100101001101
101010000000000000000000000100100011100000000000000000001101
101011110000000001011110000001101011101111100001111111000001
100000000111111000011110111000000000001111100001111111111111
111111111111111111111111111111111111111111111111111111111111
