111111111111111111111111111111111111111111111111111111111111
101111000000000001111111111111111111110111111111000011111111
101111010000110000000111111111100000000001111111000000011111
101111011110000000100111111111111011011101111111000011111111
101111001100000000000111000000111011000001111110001011011111
101111001111111111110111011111111000000000001100000000000011
101111000111111111110111011100000000000000000000000011110001
100000001111111111110110011110111000000000100100000011111101
101111001111111111110111011110111110111111000111110011100001
101111010111111111110111000000111110111111000000110011011111
101111000011111111110111011110111100000001001100000011011111
100000011000000000010111011110111001110000000100000011000001
101111001000000000010000000100111100000111100000101011000001
101111000011011111111111110000111101110000000000101011011001
111111111100011111111111110010111101110101100110100011011001
111101100000011011111111110000001001110001000000000000000001
111101111111011010000011110111111001110101000111110111100001
111101111111011011111011110111111001110001000000100111100011
110001111011000011111001110001010001111101011100100111100111
111101110011001011111000110111011101111101011110000000000011
111101110000001011111110110000011100011101011110111111110011
111101110000001011111010111111011111011100011100000000000001
111101110011101000011000110000011111011100111010000011100101
110100000011101111000000100011000000011100111010111111101101
110101111011100000000000101111010001111000101010011111101101
110101111011111111000001101111000111111000101000011111000001
110101111000000000001101100000010000000001101010011111011101
110101100010000000000000001111011100000100001010011111011101
100000000000000000001110111111011101111101000010011000011101
111001111000111111100000111111000000000001111010011011011011
111001100000111011101110100000011101000100000010010011010011
111000000000111011100000101100011100001111010010010011000001
1110110000000110111011101011010111011101110100E0010010000001
111011010000100000001110100000001100000000010000000000100011
111011011000101111111000101100001000000000010000000000111011
100011011000101110111011101101001000001111010111111110111001
111100000000000000000000000001001011101111000111111110111001
100000111000000000111111111101001011100000111100000110111101
111111111001111110011111111100000011100000000001110000111101
111111111111111111111111111111111111111111111111111111111111
