111111111111111111111111111111111111111111111111111111111111
111111111000011111000111111111101100111000001100000000010111
111111100000000011110111111000000000000011101101111110000011
110000111110000011110111111011110000011111101100000111110011
111110110000000000000011111011111011000000000111100000000011
111110101110111111111111111011011011110000011100000000000011
111110100110001101111000111001000001000101000000111000000011
111110000111001101111000000001010111000100011011111011111011
111110100111001000000000000000000000000001111011111011111001
111110100111000011100000000000000001111000000000000011111101
111110100111000011100000011111111111111010011111111111111101
111110100111111110000000000000000000111010010111111111111101
1111001101111111101011111E1111111111100010000000000011111101
110110110111111000000000000000000000000000011110000011111101
100110110111100000000000000000000001111111001111111011111101
100110110111100011111111111111111111111000001111100011111101
100110110111101101111111111000111110000011101111101111111101
100110110111101101111111111110111111111000000000000000001101
100010110111101101111111110000000000000000111111111100000101
110010110111100001111111110000000101011111100000000001000001
110010110111100000000000000000000001000000111111111001111111
110000000111111111100000011111111101000010000000000000111111
100000111111110000000000011111111100011111000001111110111111
100000111111111111100111001111110101010000000101110110111111
111000111111111000100000001111110100000000000101110100111111
111000111111111110100111101100000111110000110000000000111111
111000011110000000000111100111110111000000000101111110000011
111000011111000000000001110000000110001111011000000000001111
111000011100001111111100010111101111011111000000000101111111
111000000101111111000001010111101100000000000000000001111111
111000000000011111111101000000001110011000000001011111111011
101011101100000000001101111110001110011001100001011111111011
101011101111000001101100000110111110011001100001011111111011
101000001111011111101111110010111110011001100001011000001011
101001101111000001101101010010111110011001111111011101101011
101001100000111101101101010010110110010000000000011100101001
101000001111111101100000000000110010011111110000000000100001
101100001111111101111100000001110010011111111111111100100101
100000001111111101111111110000000000011111111111111100100001
111111111111111111111111111111111111111111111111111111111111
