111111111111111111111111111111111111111111111111111111111111
111111111110000000000111111111111111111111111000011111111111
100000000000000000010000000000111111111000001000011111111111
101111111011111111011110011111111111111011011111011100000111
100000011011000000000000011111111111111011010001000001111111
101111100011011111111111111111111111111011010111111100011111
101111101100011111111111111111111111111000010111111111011111
101111101101111111111111111111100000000100010111111111000001
101111101101111111111000000000000000000000000011111111000001
101111100001111111101000000111100000111111111011111111000001
100000000000111111101111111111101111111111111011111111011101
100111011111111111101001111110001111111111110011111111010001
111110011111111111101011111111101111111111111010111110000001
111110111111111111100010001111101111111111101010010000000101
111010111111111111111000001111101111111101101000000011111101
111010111111111111111011100111101111111101100000000011111101
111010111111111111111011101111101111111100000111111001111101
111010111011111111111011100000101111111101110111111001111101
111000000000000000000011100011101111111101110111111001111101
100001011011111111000000011000001101111101110111111101110001
100001011011000000000000000000001101110001100000000001110111
111101000011011111111011111111111101110011111111111101010001
100000011011000001111011111100110101110111111111111101011111
111101011001101111111011111101110101110111111111111101011111
111101011001101111111011111001100101100111111101111101011111
111100000000101000000000000000000001110111111100000101011111
111111111110101011101111111111111001110111111101111101011111
111111111110100000001111111111111001110000000101111100000111
111111111110101111111111111111111001110001111101111101110001
111111111110100110011111111111111001110111111100000001111111
111111111110101100000000001111000000000111111000111101111111
111100110000001101111111111111111111110001111000000001111111
11110011111111110100001111E111111111110111111000111001111111
111100111111111100010000000000011111110001111000011000001111
100000000000000001111000111111111011110000000000011101111111
111111101111111111111110111111111011111000001110011101111111
100000000011111111111110111111111000000000000000011101111111
101111111011111111111110111111111111111001111110011101111111
100000000011111111111110000000000000000000111110011100000001
111111111111111111111111111111111111111111111111111111111111
