111111111111111111111111111111111111111111111111111111111111
100000001111111111111100000000011111111111111111111111100001
101110010000000001111101111111011111111111111111101111101101
101110010110000000001100000000011111111111111111101001101101
101110010110011110111111111110000000000000000111101000000001
100000000001011110000011111111101111111000000111100011111101
111111110101011110111111111111101111111111111111111011111101
100011110101011110111110000000101111111111111111111011111101
101111110001011110111111110000101111000000000101111011111101
100011111111011110111010000000100000001111000001111011000001
101111001111000000111000111000000000000000000001111011111111
101111000000000000000000000001010000000111111111111011111111
100111110111111111111111110000000000000000000000000011111111
100111110111000000000000000000011111000001101111111000001111
101100000111111111111111111111111111011101101111111011101111
101111111111111111111101100000000111011000000000111000100111
100011111111111111111101111111001111011000001100000011100111
111011111111000000011101111111000111011111111111111111100011
111011111111111111011100000000010111000000001111111111101111
100011111111111111010000000000000111111101101111111100001111
100000000000011111010111110000111111111101101111111111101111
111111011111011111010110000000111111111000001111111111100011
111010011111011111010110000000000000000000001111111111111011
111011011111011111010110011111101111111111101111111111100011
110010011111011111010110011111101111100011101111111000101111
110010011000011111010000011000001111101000000000000000001111
110000011111000000000111011011111111101011111111100000011101
111101011111011101000000011000000000000011111100000111111101
110001011111000001001111111000001111111011111111100000000001
100001000000011001001111111011101111111011111111111110111111
100001111111111001001000000011001000000011111111111110111011
1010011111111110010011111E1011101011101011111111000000011011
101001111110000001001111111011100011101011001111111110011011
101001000000110000000111110000000011101000001111111110011011
101001001100100001100111100000000000101011100011110000000011
100001011100101111110111101111100000000011111011111100000011
101000001100100011110111100000001111101011111011010000111011
101000001100001111110111110111101111101010111000010110000011
100011000000100000000111110000001111100010000000000000000011
111111111111111111111111111111111111111111111111111111111111
