111111111111111111111111111111111111111111111111111111111111
111111111111111111110111111110000111111111111011110000000001
111111111111111111110111111110111111111000000000111000001101
100000000000000000000111111110000000100010000000011011111101
101111111111111111110111111110011111111010111111011011111101
100000111110001111110111111110011111111010111110000000001001
100011111110101101100100000010000011111000000000110111111001
111111111100101001100000000011111000000010111111110111111001
111000001110101001100110011110000011111110111111110111111001
100001111110101001100000011111111011111110011111110111111101
111000101110101001111111000000000011111000011111100111111101
100000100000101001111111111111110000000010011111110000000001
100111100110101000001111000000000000000000011111110000000001
110000101110000000000000000000111111111111000000011111110101
110110101100111111111111110000110011111111111111011111110101
110110101100011111111111111110100011111111100000000111110101
110110100100011111111111111110000011111111100000000000000101
110110101100000000011111111111111111111111100111001000000101
1101101011000000000000000111111111111111111001110011100E0001
100000001101111111111111011000000000111111100000000000110111
101111000001111111111111000000000000000001100111001110000111
101000000000001111111111111111111111111101100100000010110111
101111111100001111111111111111100000111100000100011010000111
101111100000001111111111111111111110001111110101000011110111
101111100011110111111111111111110000000000010101010011110111
101111101001100011111111111111100111110000010101010111110111
100000001000001011111111111111100111110000000100010111110111
101111101000000011111110111111100110110111110101000011110001
101111101001100000011110111111100110110000000001110011111101
101011100000000111011010111111100000000111111111110011111101
101011101111100111001010111111101110110000000111110011101101
101010001000001111100010111111101110100000001111111011101101
101011111111101100011110111110000010000001101111111011101101
101011111000001101111110101110011010110101101111110000001101
101011111111101100111000101110111010100100001111111011101101
100001111111100000000000000000001010000000000000000011101101
101000000011111111110011111111110011110000000000000011101101
101011111100000000000010111111110011110011111111100000000001
100011111111111111000000111111110000000011111111100011111111
111111111111111111111111111111111111111111111111111111111111
