111111111111111111111111111111111111111111111111111111111111
111111100111111000000000011111111111000000011111111100000001
111000000111111110111000000111111110011101100000111000011101
100000000001111110000000010111111110010100000000000001111101
100000000111111011111111010000111110010101111101111111111001
100000000000001010000000011000000000010100000000000111111101
100000000000000000000110000000110000000000011101110001111101
100000000000001000000000000000000010000011000001110111111101
100000000000000000000000011110000000111011111111110111000001
100011111111000000000111111110110000000011101111110111110001
101111111000000011110111111110110100000000000000000110000001
101111111111111110000000000000110100001111000000000000000001
100000001000000110111110000000000100000000000000000111111101
101111111001111110000000011111100001101001100000000000000001
101110000001111111111111000000000100000001111100000000000101
100011111100000000000000000000000000010001111111000111110101
101111111101000000000000000000000111111111100000000111110101
10111111100000110000000011111111010000000011111E000000000101
101111111111101101111100100000000101100000111110000000000101
101111111111101100000000111111110000001110111111101111110101
100000000000001111111111111111000111101110111111101110000001
101111110000100001101110000001100111100110110111000000000001
100111110110101111101110000000000000100110110111010000000001
111111110110001111000000000000101101100110010111011110000001
100000010101101111110111000000000001100110000111011111000001
100011010101100111110111111110101111100110011111000001111101
111011010101000111110001111000000000000110011000000000000001
111010000101000111110111011110011111010110011111111001111111
111010011100000111110100011110011000010110011111111001111111
111010000000100000000011011110011111010100011111111001111111
111010011111110000000000000000011111010110011111111000000111
111011111100000000000111100000000000000110011111111001111111
100000000000011100000000000000011111110110001100111001111111
100000000000100001110001111000000000000000011100111001011011
111110000000111001000000000001011000001111011100111001011011
100000000000111001110000000000000000001100000000000001011011
101100000000111001100000000001011111101110000000000001011011
101110111100111001100000111101011111101100100000011001001011
100000000000000000000000000000000000000000000111111100000001
111111111111111111111111111111111111111111111111111111111111
