111111111111111111111111111111111111111111111111111111111111
100000000000001111000000000000000011111111111111111111111111
101111101111101111000000000001111110111111111111110000011111
101111100000001111000000111111110110111111111111100001111111
101111101111111110011111111000010110111111111011111101111111
101111101110001110011111111000010100111110000000000001111001
101111101110101110011111111011010100000000000011000001111011
100000000010100000000000001010000000111111011111111000000011
101111101010000110011111111000001010111111011100000000011111
101011100011000010000000000000011010101111000000000111111111
100000100000000010000000000101000000001111001100011110111111
100000111011000011111100000001000010001100011111011110111111
110110111000011111110000000000011011101110011111000000000001
100110011111011111100011111111111011101000000000000000001111
101100010111011111111011111111111011101000000000011111000001
101110010001011111110000000000000010001001101111111110110111
101100000000011111101011111000011000001000001111000000110111
101110000111011001101011111000000111101011100000000000110011
100000011000000000D00011111000011111100000000000000110000001
101110000011111110110000011000000000000011111101100111111101
100000000011111110110111110000000000000000000000000000000001
111110000000001110110000000000011111000000111100011110000101
101110000001111110111110000010000011000000011111011011110001
101110110000000010111111111010111111001111001111010011111001
101110110111111110000001111000001011000111101000010011101001
100000110111111110111111111010101011000111101111000010101001
100000000000000000001111111010001011000111100000000000101001
101111111111111111101111100D11111011010111100000000100101001
1011111111111111111011111011D1111011010100000000000000001001
101111111111111111101000001101111011010101101111110100000001
101111000000000001101111100000000011000101000000000101000001
10111111111111110110000000011111E111011100000111110100000001
101100111100000001101110001111000000000100000111110000001111
100000111101111111101111101111000001110000000000110111111111
101100000001111111100011101111011111110000000110110111111111
101100111101111111111001101111011111110111110110110111101111
101100000001111111111011001111011110D00000000000110111101111
100000000001111111111011101111000111110111111100000111101111
111111110001111111100000001111000000000111111100000000000001
111111111111111111111111111111111111111111111111111111111111
