111111111111111111111111111111111111111111111111111111111111
111111111111111111111111111111111111100000000011111111111111
111111111111111111111100001111111111111111111011100000000011
111111111011111111111111000011111100000111111011111111111011
110110000011111110000010000001100000000000001011111011111011
100111111011111010000010000001111111111110111000000011111011
110011110000000010111010001111110000000000111110000000110011
110111100000000000100010001000000011111000000000000000111011
110111111111011110000010000000000000000010011111111100000001
110111111000000000000000000111100000000000011100000001111101
110111100000000000000000000111000001101111111101111111000001
110111111111000111111010000000000001001011110000011111111111
100000000000011111111000111101110111101011111101111100000001
100011110000011110000010111101110111100011111100011000000001
111111110010010111111010011101110111101111111111011000000001
111101110010010000000000011101110111101111111111011011110111
110101110010011000000000011100010111000000111111011010000111
110000000010011111000000011101110111111110011111000011111111
100110000010011110010000000000110111111110011111111011111111
110110111010000010011111111110000101011110000000000000000111
11011011101001E11101D111111000000101011110001111111010111111
110110111011011011010111110111110000011110001111100010100001
110000000011011011010100000000000000000000001111111010000001
100000000000011011010111111111110011111110000011111000101111
111111111111011011010111111111110011000000000011111110101111
100011111111011011010000011000000011011111111100000000101111
100000001111011011001100001011110000011100001101111100000001
100000000000000011011101001011110011111111101100000000000001
101111000000000000000100001011110000000001101100111111111111
101111000111111111111101100011110001110111101101110000111001
101111011110000000111000001111000111100111100001110111111001
100111011111101111111011001111110111100100000000000000111001
100011011111101111111011011111110111100101110000000110000001
110000010000001111111011000000010111100100110111111110100001
100000010000001111111011000000000000000000110000000000001111
100001111111100001111000000111011000111110110111100100100111
101111000000100000000011111110000010000010000000000100000111
100010010000000000000001101110111110111110111011111111000111
111110000000000000000000000000111110000000000000000000000111
111111111111111111111111111111111111111111111111111111111111
