111111111111111111111111111111111111111111111111111111111111
101100000000000000000000000001111111111111111111111111011111
100000100000000000000000000000011110000000111111111111011111
100110111111011100000000000001010000000001111111111111001111
100110111111000000001110011111010111111101011111111111000001
110110111111001111111110000011010111111101011000000000011101
110110111111000000000000111111010000000000011011E11111011101
110110111111001101110111110101010000100111011000000000000001
100010111111000001110000000000000000000111011111111110001101
101110000000000011110111100100001111111111011111111110011101
101110000010100011000000000101100000000111011111111110000101
100000000000000011000000000001100001110111011111111110000101
111111111111111111111111110100000111110110011111111110000101
110000000111111111110000000001100000000111011111111000000001
111111110111111111010111100001100000000111011111111111100001
110000000000111111010000000001100011000011000011111100001101
110000111110111110011101111111101111011111001000000101101101
100001111110000000000000111111101111000000010011110101101101
101100000000011111011100001111101000000011000011010101101101
100000000000001111011100000000001111111000010010000100001101
111110000111001110000000000000000000000000000011100001101101
111110111111001000000011111111111110000000111011011101100001
111110111111001011110011111111111110111110111000010000000001
111100111111000000000000000111111110101100011011011000001101
100000000000000000000011111111000000100000111010000000000001
100001111111111000000001111111111110101100111000000001110001
111111111111111100000000000111111110101100111011000111011101
111111111111111101111110111D11111110101000011011000000000001
111111111110000000000000000000000000000000011011110111011101
111100000000000000000000000011111111111100011011110111011101
111111110111111100000111110100000001111100011000000111000001
100000100111111101111111100000110101111100011011100000101101
101110100000000001111111111110110101111000011011111110101001
101110000000000000110111111110110101111100001011111110100001
101110011111100000000000000000000000000001100001111110101101
101110000000001110111111000000011111111111001101100000101001
100000000000001110111111111110111111111110001100100000001111
111111111111111110111110000000000100000000001100100100001111
111111111111111110000000000000111111101111111100000111111111
111111111111111111111111111111111111111111111111111111111111
