111111111111111111111111111111111111111111111111111111111111
101101111111110000000000000000011111100000000111111111111111
101101111110000011111111111100000000000000000111111111111111
101101111100000001111111111101111100001111111111111111111111
101101111100000000101111111101111111101111111111111111111111
100100000000111111101111101100111111101111111111111111111111
100111111110111100000000000001111111E01111111111111111111111
100111111110001111111111111110000000001111100000000001111111
100110111110111111111111111110011101111111101111101111111111
100110111110111111100000011110011101111111101111101111111111
100110000110111101111111000010011100000111101111101111111111
110110111110110001111111111010011100110111101100001111111111
110110100010111001111111111010011100110111101101111111111111
110010101110000011111111111010000000000011101101111111111111
110000000000011111111111111010111111111111100001101111111111
100001100111110000111111111010111111111111111001101111111111
110001100011111110111111111010111011111111111000101111111111
110000100000000010111111111010111011111011111100001111111111
110110100111111010010000000010111011110011110101101111111111
110110110111111000010000000010111011110011110101101110000011
100110110000000000000000000110111000000011110100001111111011
101110111111111101111111111110111001101000110111101111111001
101110111111111100011111101110000001101110110111101111111101
101110001111000001111111101111111001101000000000000000000001
101110101111111101111111101111100001101000001110000000000101
101110100000000000111111101111111001101011111110111111111101
101110000000111100000000101111111001101011111110111111111101
101110111111111101111111101111111000001000000000000001111101
101110111111101101111111101111111011111000000000000000110001
101110111110100101111111101111111011111011111011111110111111
100000000000000000000111000000111011111011111010111110111111
100011111111111111110111111110111011111000000000011110111111
100000001111000001110111111110111011111011111111111110000011
111111100000001100110111111000111011111011111111111111111011
111111111111101100110001111011111011111011111011110000000011
111111111111101100111101111000011011111000111001100000000001
111110111111101100111101111011011011111110000001111111111111
111110111111101100111101111011011011111110111101000000011111
111100000000000000000000000011011011111110000000011111011111
111111111111111111111111111111111111111111111111111111111111
