111111111111111111111111111111111111111111111111111111111111
100000000000011111111111111100000000011111111111110000000101
1010001111010000000000000D0000011111011111111111111111110001
1000111000010100000111111110100000010111111000D0000000000101
100000000000000011011111111010111111000011101111110000000101
100000000000101111011111111010111110111111100000111S11000D01
101111111111101111000000000010111110110000000000101111000101
100100000000001111110000000000111100110000000110101110000001
10111111011110D000000011111110100000111001110000000000000101
10000000001110111111101011111010111011100000001111111101D101
11111111101110000111101000D000100000001011100001000000010101
11111111101111000D000010111011100110111011101101111101000101
110000000011110111111010110011100000000011101101111100011101
111111111011100001111010000011101100111000001100000101D11101
111111111011100111111010000011101100000000000010110101011101
111111111000000111110000000011101100101100001110100101001101
100111111000001011110000111110000000101100001110100101011001
100000000001111011110110000000000000101100001110100101011001
111111111001011001110110111100000001101111000000000101000001
101111110000011000110110101101111111101111001111110100000001
10110100000001101111011010000011111110101100001111D101110111
101101000011011011110000101111110111101011000011110100D00001
100001011111011001110111101111110001101011001111000101110001
10100101111100D001110111001111110111101011000001011101110001
101D110100001111000D0111001111110000000000011011011101110001
100000010110100001110111000111110111111000011011011100000001
111011000110101000000000000000000111111111000000011100000001
111D11000000100001001100000000000000000011011011010101110111
100000011111100001000000001111111111111111000011000001110111
111111111111111111111111111111111111111111111111111111111111
