111111111111111111111111111111111111111111111111111111111111
100000000011000000000000000000011011111101111111100000000011
111111111001111100000000000000010000000101111111100000000111
111111111001111011000000000000011110110100000000001101111111
100011011000011011111000001000000000100101111111111000000001
101111000001011011111111101110000000000101111111111101111101
101111010001010000000011101111111011100100001111000000000001
100000010001010011111111101111000011100111100001111000111111
1010010000010100111111000000000000000001011001011E1000000001
101010010100000011011000000000000000000000000100000000001001
100010010010110110010100000000011111011111100100000001011111
111011010010110110000000001101110000000011100001110000011111
110011010010000110011100001101111011000000001101100011011011
110000010000000110000011111101111011000111100001000011000001
110111000100000000000000000000000000000111100101111011110001
110100000000000111100000001111000000000111100101111011111101
110101111111110101100000000000000111100101100100000011111001
100001111110000101100100000000000011100001100000000011111001
101111110000000101100111111101000011000101100101111101011011
101111111111110000000000001001011001000100000000000101010001
101111111111110000000000000000001000000100110000000000010001
101110000011110111000000000000000111000100110111111111010001
101110100010000011111100000000000111000000000000111011000001
100000000000000011100000000011111111010000000000101011000111
111111111111110000011111111011100000010111111110000011000111
111100000011110000111111111000000110010111111110011111000001
111111100011110110111111100011110110000111000000011111010101
111110110000000110111111111001100110000000000000000000010101
100000010111100110000001111001110111000000000000000000010101
101111010111100110011111111001110000011110111111111100000101
101111000000000110001111111001110111011000001111111011110101
101111011111110110011111111001110100010010001111111011110101
101111011100000110011111111000000000000010000010000000000101
101111011110000000011011111011111110011010100000010000000001
101111000110100001111011111011111110011010000000000111111101
101111110110101101111011111011101110011011100000000011111101
100000000000001101111000000000000000011011110011100100000001
100000000110000001111001111011111111011011100000110000011111
111111111110111111111001111000000000000000000011111000011111
111111111111111111111111111111111111111111111111111111111111
