111111111111111111111111111111111111111111111111111111111111
100000000011110011111111101111111100000000000001111111110111
101110111011110000000000100000000000011111100000000011110111
101110111000000000000011111111111111011100000011111111000001
100100000011100111111011111111111111011101011110000000001101
100001111111100111100011111111111111011100000000000000000001
111101100000100111111000000000000000011101111111111111111111
100100000000000000111001111111111111010101110000000000000001
101100000000000000111011111111011111010100011011100000000001
100001110001111100000000000000011111010100111011111111000001
100000000110000011000110000000000111010100100000011111111011
101111110110111011011110111111110001000000001111011111111011
100000000010111011011110001111110111111101101110011111111011
111111111000101001011110111110110110111001001000011111000011
100110000011101000011110111110000000001100000000000000000011
101100000011101101010110111000000011000000100000110111110011
101110111011100001000000111011110111000111111111110111110011
100000001011111101010000111000000111111111111111000100000011
101000001000111101000111000001111111100000000000000000000001
100111101110111101111111110000000111101111100000001101111111
101111001110111101111110110111100000001111101000000001100001
101111000000110100111110110000000111111111101111111101011101
100000001111110100111110110000001111111111100000011100000001
101011101111010000111110110000000010000010000000001111111111
100011101101011100111110110110000010101011110111101011111111
100000000101011100000000000000011000000000000111000000000001
100010101101000000000000000010000000000000000000111010111111
1000000011000011110111110110000011111110000000001110E0000001
100011001101111111011110000000000000000000000000111011111101
100011000000000010011111000000111110000001110100000011111101
100000011111101001001111101100000011111000110100110010110001
111111111111101001000000000000000000011000110100100000000111
111110000001101000000000000000000000101000110100101101111111
100000000000101011111000000000000000000000010000100001111111
100010101100000011111011011111111111111000110000101001111111
101110101101000011110000011111110000000000000000101001111111
101110001101110011000011010111010000000000111100001001111111
101000000001111010111011000111000101111111111100111001111111
100000000001111010000000000000000001111111111100000001111111
111111111111111111111111111111111111111111111111111111111111
