111111111111111111111111111111111111111111111111111111111111
111000000000011111100000000000001101000000000000000000100001
100011111111011111101111001111110000011111100110111110101101
101000000000011111101111000000011111011111101110000010101101
101000011100011111100000000000011111011111101110111110101101
101011001100001111100001101100000111011111101110111110000001
100001101100000000100111101101111110001111101110000000011101
100001100000010101100011100001111110101111001111111100000001
100000000000010101101111001101111110101111011111111101011111
101011111111110100001110001101110000000000000111100000011111
100011111100000000000000000000000001010011011111111011111011
101111110000011100111111111111111100010111011101111010111011
101111110000011000100000011111100000010101011101111010111011
101111110001111100110000011111111111000101000001111010011011
100000000000101100110100000000000000111101111001110000100011
111111111110000000000111100000011110101101111001111000000111
110000111111101110100000000000000000100000000001111111010111
110000001101101110101111111111111101101001111000101111010111
100000000000000000000000011111111101101001100011101111010111
111101111000000111111110001100000001101001101111101111010111
111101111111111111111110001111111101101101001110101111010111
100000000000111111111111100001111100001101001110100000000111
101111111110000001111111101111111100001101001110100111110111
101111101000000000000000100000111111100000011110100111110111
100101101111111111111110101110100000000001000110100001110111
101101101111111111111110100000100000001001000000000001000111
10000000000000000011111010111010E000000000011000001001110111
101101110000101100000110101000001011111000001110001001100111
101000000011100000000000001011011011111000001110000000000111
101111111000000101111111101011011011111011000000110111111111
101111000111010101111111000011011011000000000000110111111111
100000000110000000010110111011000010100011100000000000001111
101110000000111100000000000011111110000011001111110110001111
101110111100111111100000000000000110000001001100000000111111
100000010000111111111111111101111110001001000000011110111111
100000000110000000000000111001111110001000001011111010110001
101111110110000111011111111001111110000000000011111000111101
101100000110000100011111000001111110011111111111111010111101
100000000000000000000000011100000000011111111111111010000001
111111111111111111111111111111111111111111111111111111111111
