111111111111111111111111111111111111111111111111111111111111
111111101111111100000001111111100011111111111111000000001111
111111101111111111111101111100000000011110000001111111001111
111111100000000000111101100000000011111111111100111111000011
111100000000000000000101101111111110011111111101111111000001
111111111000001000110101001111111110011111111001111011011101
100011111000001111110101000000000110011111011000011011011001
101111111111000001110001001111110110000001011001111011011001
101111111101111001110101001110000000001111011001101011011111
100111111001111101110101001110111111100000000101101010011111
100111111101111100110101001110111111100000110000000010011111
100111111101111110110001001110000000111110110000000010001111
100000000001111110100110001000111110111110000001111110001111
1111111110011D1110100111001010111110111111111011111110001111
111000000001100000100111000000111110000000000011111110000111
111111111000111110100111011111111111100000000011111100010001
111111111010111100100111011111111111101111111011111111000001
101000000010000000000000011111111111101111111011111011110101
10110000001001110111111E111011111111101111111011111000000101
101111110000000000000000000000000000001101100000000011110001
101111000111011111111111111110111111111101101111111000000001
100011000111011111000011100000111110001101001100000000001111
1011110001110000000000D0000000111110111101001101111111111111
100011000111011000000000000000000000111101000000001110111111
101000011111011011011000000011111111111001011111101110111111
101000000000000000011000011111111111111101011111101110111111
10011111101100000001100111D000111111111101011111100110111111
100111111011000001011000000111111111110001011111100000000001
100000000000001111000011100111111111111101011111100001101101
100111111110100000000011100000110111111101011100000001101101
100111000110111111111011100000110110000101011111101111001101
100111011000000011111010001111110110111100000011100001101101
100000000011111100001011111111000000011111011111101111101101
100111111011111111101011111111111111011111000000001111101101
100111111011111111101010000000000000001111111000001100000001
100111011000011111101011000011111111101111111101100001111101
101000000000000000000011001100000000000000000001000000000001
101011111100000000000000001110101111110000000001111000111101
111000000000000000000000001110000000111111111100000000000001
111111111111111111111111111111111111111111111111111111111111
