111111111111111111111111111111111111111111111111111111111111
110000000111111110000000000000001100000000000000000111100001
110000001111000000000011111111100000000000001111011100001101
110100001111000000110000000000000111111111100000000000000001
110101101111111110110111110000000111100000011100000000000001
100101101111110000100111111111110000000000011111011111111101
110100000000000000110111111000000000000000000000000E11110001
100000111111111110110000011011110111111000000000011111111111
100110011111011110111111111011110111111111111110011111110011
110000001111011010111111111011110111110111111111011110000111
101001111011011010000000011011000111110000001111011111100111
101000011010011010011111111011100111110001000000000011100111
101000111000111010000111111000000111110111001111000000000111
101001111011010000110011111111100111110111101100000111110111
101111101011011001110011111110000111110111100000000011110111
101111101000000001110011110111110000000000101111110111110111
100000000011110001110000000100000000000011001111100111110111
111111110011110000000000000111111110011111001111110000000111
111111110011111011111010101111111110011111000001110000000001
100111110011111011110000101110000000011111010111111100000001
110111000010000011110000000000000010011011010111111111111101
110000010010111011110111000000000010000001000000000000000001
111111110000111011110011111111100010010110111111111111110001
100111110000111011110111111011100010000110101111111111111101
100000110100000011110001111011101000000000101111111111010101
100000000100000000000001111000001111111100101111111110000001
111000010101001111110011111111101111111101100000111111111101
111110010101001011110000000000000000000000001111111111110101
111110010100000000000000000111111011111101111111111101110101
100000010000000111111000100111010000001100000111111101110101
101110010100000101111010110111010001101100000000000000000001
100000000101111101111010110000000001101111011111111111111101
101011111100000101110000111111111001101111001111111100000001
100000001101111101100000111101111001101000001111111111111101
101101111101100000000000111101111001101011101100010000000001
100001111101101000011000000000000001101000000000000000000011
101100000001100010001000000001100011100000011111110111111111
100000000101100000000001111001100011111000000000110111111111
100000110000000111111001111000000000000000001110000111111111
111111111111111111111111111111111111111111111111111111111111
