111111111111111111111111111111111111111111111111111111111111
111110000000000000000000110000001111111111111111111111110001
111111111111101111111110111111101111111110000000000001110001
111111111100000000000000000000001111110111111111000001000001
100000000011111100011000000000001111110000001111111101111101
100000000111001101111000011001000000000111001111111101111101
100000111110001100111000000001110000000000000110000000000101
101111110000100000111100000100000000000111110000001111000001
100000001111100000000000010111111111110000000111100101101001
111111101111101111110000010011111000000110111100000101000001
100000000001101111110110010111100001110110111100000001000011
101100000000001111100000010110101111110110110000001101111111
100001111111100111111010000110101111110000000011100000000111
100011100000100111101010000110100000000110111000010111110111
100000000000100111101010000000101110010110000000000011000111
100000000110110101101010110111101111010111111100000111011111
100111111000100101101010010001100000010111111111111111000001
100111111000100101101000000111100000010111101111000111111101
100110000000000101100000010111100000010000000000000000011101
100101111111010001111100000000000000000000000000001100000001
100101111111010011111100110000011111111111111111000001111101
100001000011010011000000010011111101111111111111011101111001
100111111011010000000000010000001101100000000111001100000101
100111000000010110000000000000000101111000000111011101111101
100111011111010110111100000000001101001111110011000001111101
100000011000000000001000111111100001001111110011111111111001
100011000001001111101000011111100100001111110011111111111101
100011001110000111101000011111100100001000010000000000000001
100011001110001110101010011111100110000000000000000000011101
100001000000000000100000011111100100000011111111111000000101
100000000111101111101100001111100001111011110011110000000001
100111100111001111101001100000001111100011111011111111100001
100001100111100000001001111110000011111011111000000000000001
101111100111101111101011111110001111111011111011111101000001
100011000111101110001000000000001100111011111011111101000001
101111100110000000001111101101001100111000001011111101011111
100000000111110001011111101101000000000000000011101101011111
10111000011100011101111000000100E111111101110000001100011111
101111111111110000011111111100000000000001100111101111011111
111111111111111111111111111111111111111111111111111111111111
