111111111111111111111111111111111111111111111111111111111111
101111111111111111100000111111111100000001000000001101111111
101111111110000000011110111111100000011101000000111101111111
101111111110111111000000011111111101111100000000000000000011
100000000000000000111111011101111101111000000000000000111011
101110000000001111111111011001111101111100000010111110111011
101111111010000000000000010001110000000000000000001110111011
100001110010000111111111110001110111000000100000001110110011
100000010010110111111111010000000000000010101111111110110011
100001010010110111011111000000100110011110000000011110110001
1111110000D0110111000111000110100100011111111111011110110101
101100000010110111011111000000000100011111111111010000000101
100000011010000000000001001110100111111111111111010000111101
101111011010000000000000000000000000000000111011000011000001
101111011000000101111000000000011011111110000000001011001001
100111011111110001111000000000000011111111111100000011100001
100000011111111101100010011111111110000001000000000001111101
100000111110011100000010011111111110100000011111110100111101
100000111110111101110000000000000000101111011110110101111101
1000001111101111000D0000000000000000000000001110110101111101
100010111110111100011011111110000000000000001110110101111101
111110000000000000000001111111111111111111000000000100000101
100000011111110000000001111011111111111100001111100000110101
100000000000000001011101111011111111111111101101101111110101
111111110100000000001101111011111111100001101101101111100001
110111110111111111101100011011111111101000001100000000000001
110111010111111111101111011011110000101001111111011111111001
110011010111110111101111011011110111101011111000000011111101
110111000000000001101111000000000001101000101100011111111101
10011101111011111110111111110D111111101100101111011000000101
110101011110111111101111111101100000100000000001010011110001
11000001111011111100000000000000000000111100000101101E110111
111111011110001111000111000000000000000000011000000000000111
111111011110001000000011111100000001111000011011110111101111
111111011110001111101110000001000100000000011011110000001111
111111000000011111101111111000000101111000011000000011101111
111111011110011111100000000000110101111000000000000000000111
111111011110000111111100000000110001000000011110000011101111
111100011110111111111100000110000000000011000000111000000001
111111111111111111111111111111111111111111111111111111111111
