111111111111111111111111111111111111111111111111111111111111
101000000011101111111100001111111111111000000101111011111111
101111111000101000001100000000111111111011111101110000011111
100000000000001011001100111110111111111001111101111000000001
100011000000001011001100111110110000001000101100111111110101
111000000110100010000000000000000011111100101000111111110101
111000000000101011111111110000111111110000000000000000000001
111011111111101000000000110110111111111111000111101101111111
111011111111101011011110110000111000000000000000001101110111
100000000000001011011110110110111011111111000000000100000111
101111111011111010000110000110101011000001100111110101100011
100000011001000000110110011110001011111101100111110101100001
100000011011100000110110001110001011111101100111100001111101
100000011000000011100110001110111011111101100000000101111001
100110011000000001100110011110111011111101100001011100000001
100000011010000101100010011110111011111101101111011100000001
111110000011110101100010011110011011111101101111011111111011
111110011000000001100010111110010011011101100000000000111011
111100011111111100000010111110011011011101111111101111111011
111100000000000001111110000000011011011101111111101111111011
110000000001111101110000111110000011000001111110001111111011
100000000111111101011110000000111011111001100000001111110011
111100000001111001011110000000110011110001111000001111110011
111101111111111000000010100000110000000001111011101111110011
100001111111111010111110000000110000000001111000101111110011
101111111111111010111110000000110000000001111011101110000011
101111111110111010011110000000110011010001111011100000000011
101111111110111000000000011110110011011001111010101100111111
100000000000111011111110000000110011001000100010101100111111
101111000001000000011110000000000001001001111000001110111111
10000001111110100011111011111111100000100111000000E110100001
101000001111101000000000111100000011101000000011100000000011
100000001110100000000011111101111111101001111110001111111001
100000000010101111000001111101111111101001111110100111111001
101101111110000000000000000001111111000000000000000001111001
101101000000001111010111111101111111111111111111101111011001
100101111111000000010000000001111111111111111100001000010111
100101110000001111111111111100000000111111111111101010010111
100001111100100000001111111100111111111111111111100010000111
111111111111111111111111111111111111111111111111111111111111
