111111111111111111111111111111111111111111111111111111111111
111111111111111111111111111111111100111111111110000011111111
111111111111111111111111111111111100011111111110111111111111
111111111111111111111111111111111100011111100000011111111111
111111111111111111111100000000000100011111110111111111111111
111111111111111111111111110111111101111111110111111111100001
111111111111111111111111110111111101111111110111111111111101
111111111111111011111100000011111101111111110111111111111101
110111100000000000000001111111111101111111110000000001111101
110111101111000001111001111111111101111111110111111100000001
110000100000000111111001111111011101111101100110000000111111
110111101111110111000000000111011101011001110000111111111111
100000001111110100000001110000011100000001111100111111111111
111111111111110101111111110111111111100001000000111111111111
111111111111110101111111110111111111111101011110000000111111
100000000101110101111111110111111111111101011110000000000011
101111111101110101111111110111111111111101011110011110100001
101111111000110100000000000000000000000001010000000000101001
101111010000000011111111011111011101111101011111101111101001
100000000111110011111111010111000001111101011111101111101001
111111111111110011111111010000011111111101011111100000001001
111111111111100000000000000000111111111101011111111110111001
100000000011101111111111111111111111110001011111111110110001
100001111011101111111111111111111111010111011111111110111101
1001E1111011101111111111111111111111010000011111111100000001
101011000011101111111100011111111111011111011111111101111111
101011111000001111111111011111111111011111011111111101111111
101011111111101111111111011111111111011110011111000001111111
100011111111100000000000011101110111011111000000000111110001
100000000000000000000000001101110111000000000000011101110101
100111111111100000001111111100000111111111000000000001010001
100110000001101111100000101100110111111111011011111101010001
100111111101101111111111101101010111111111011011111100010001
100111011100001111100000000000010111100000011000111101010111
101111011111101111111111111110000100001111111000000001010111
101111011000001111111111111110001110100110000011111001010111
101110001111100011111111111110001110100111000000000000000111
101110001111101111111111111110001110100111111111100000000001
100000001111101111000000000000000000100000000000000000000001
111111111111111111111111111111111111111111111111111111111111
