111111111111111111111111111111111111111111111111111111111111
110000000000000000000001000001000000000000000111111100000111
111111111111111100111101000001011110000000000000000001111111
111111000011111101011101100000000111111101011111111101111111
111100000000001101011101111110011110000001011111111101000001
100000000000001101011101111110011111110101010001111101011111
100000001000011101001100011110011111110000011101111101011111
101111111100111101011100000000000110000100000001110101011111
101111111100111101011111011111110000110000000001110101011111
100000000100001101000000011111110111110011111001110101011001
101111110001101101110100000001100111100001111001110101011101
101101110011101101110111110100110111110000000001110100011101
101000000011101100000000110100110111110001111101110000011101
101111101110000000111110110100010111110001011100001101000001
10111110110100D110000000000000010000000000011000000000000001
100000000001001111111111111100000111110001111111111111111101
100000000000001111111111111101111010110000001111111111101101
100111111110001100000000000000000000110111111010111101101101
100000000111001000D00000111111101100100000011010000000101101
100000100000001101111111100000000010101111111000111100000001
101000001111111100011111100000001010100011000000001111010111
101111101111000001111111101111000010100001011111100000010111
101111101111111101111111101110110000000001011111101111110111
101110000100000001110000101110000000000101011111101110000111
100111100110010110000011D01110100111011101000000100000000001
101000000000000111100011101100100111000001111110100000111111
101110111110000000000011100110100111111101111110101110111111
100000001110000001110011100010100001000001000000101110111111
100000000010001101110011000000101111111101111110101000111111
100000000110000000000000000001101101101101111110101000100001
111111110010100001111000010000000101101001000000000110111101
111111110010101101101111001101111101100001000000010000111101
1000001000E0101101001110011101111101101100001100000000111101
110000000010101101001111000001111101001101100011110000111101
111111111010001101001111111101000001001100001000000000000001
111111111000000000001000000001111101000101111011100000110101
111111111000000001100000000000000000000000000011100111110101
111111111011111000001111111000000000000000111111111111110101
111111111011111110000000000000000000000001111110000000000101
111111111111111111111111111111111111111111111111111111111111
