111111111111111111111111111111111111111111111111111111111111
111111111001111000111111111111111111111111000000000111011111
11D111111000000010110111111011111111000000000001111111011111
100000000000000000110111111011111111011110000001110000000001
101111111111111110110100000000000011000111111000000110111101
100000000001111110010101110000011111011111111111110110111101
100011111111111110110101111111001111010000000000110000000001
100000000001111100110101110111001100000100011111100111111101
111111111101100000110101110000101111110101011011110110000001
111111111101000000110101110110101111110101011000000110000001
111000011101111100000001110110101111110101000011011110111111
110011111000011100111100000000101111110100000000011110111111
101011011000000000111111000000000011000000000000000000111111
101011011001111110000000000000000000000000000011100001111111
10101100000011D110111111111111111111111111111111111101011111
101011011101000010111110000000000000000111111111111100000001
101011000000011010000000111100000000010111111101111111111111
101011011000000000111111111101111111110111100000011100000001
101000011000001111111111111101111111010111101111110000000001
101011000000111111111111111101111100000111100000000100001111
100000000000111111100000000000000011000000000000000000000011
101000000000111011101111111111110011001111111111000000111111
101111101110000000001110100000110000001111111110011111111111
101111100110111100000000101111110001111111111110000000000001
101111101110111000000000000000000011111111111110100011111101
101111101110111011100011111111111111101111111110001111111101
101111101110111011110001111111111111101111100010000000000101
101111E01110100000000111111D11111111101111101111100111111101
101111101010000001100110000000000111101111101111100000011101
100001000000000000100111111111110111101100001111101111111101
101111111100011111100000000000000000001111100000100000000001
100000000000011111101111101111100111101111101111111111111001
101111111111011111101111101110000111101111101111111111111001
101111111111011111100011101111100D11000001101110000000001001
111000000001011111111111101111100011101110101110111111111001
110010001101011111111111101111101011101110101110111110111001
110011101101000000011111101101100011100110101110111010111001
110011101101001111111111101101111111100110101010001010111001
110000001100001111111100000001111111100000100000000000000001
111111111111111111111111111111111111111111111111111111111111
