111111111111111111111111111111111111111111111111111111111111
100000000111111101101100000000000000010111111111111000001001
100111100111111101101101111111111111110000111111101011111001
111111000111111100101101101111101111110011111000000011111001
1000D0000001111101101101100000000111110010000011111111111001
100001000000000000001000001111101110000011111000111111100001
101111110000001111001111101111000011111001111110000000001101
101110110100000000001111101111111011111011011110011111111101
101110110111101010001101100011111011101011001110011111111001
100000000D01101011101101100011101000001011001110010000111001
101110111101101011101101111011101011111011000010010111111001
10000000000D000011101101111000001000000000000000000001111001
111111111111110011101101111011101111111110000000011101111001
110111111111110011100001100000001000000000111111110101110001
110000000000000000000000001011100000000000000000000100101001
110011111000000000000000000000001111111111111111100101101011
110000001001111111101011100011000111111111111100000101101011
100111111000000000101010000000100000000000000011100101101001
110000000100000000000010100000000000000000000111101101101101
100111111100000000000000000000001110011111111111101100000001
101111111101111111111111111111111110000000000000001101111101
100000101101111110000000111111000001011111111111111100001101
100000000101110110111100000000000001011111111111111100000001
100011111101110010111111111111110000000000000000110100001101
100000001101100000000001000000001000000111111011110011111101
111111011000001110010000000101111000000000000010100000000001
111111011110001110010100001101100000001000000110111111111101
111111011110000110010100111101111010101111110110000000111101
100000010000000010000000000000000000001111110110110111100001
101010010101111110111111000000000000000111110110110101111111
100011010100000010111111011111101001110000010100110100001111
100011010101000000000011001111101001111110000100110000001111
101011010100000111111111000000001001111110110100110001111111
101011010101010111111101000000001001111110000100110000001111
100000000000010111111101111000000001100000110000110000111111
1000000011010101111111011110111011011E1110000110110000000111
100111101101000111111101101000001101111111111110110011110111
100000001100110111011101100000001101110000000000000011010111
111111000000000000001100000000001101111111110000111000000001
111111111111111111111111111111111111111111111111111111111111
