111111111111111111111111111111111111111111111111111111111111
101000001111111111111000000000000000000000000000000000000111
101001111100010111111111111111101111111100001000110111101111
101001110000000111111111111111100001000110111010110111101111
101001110111110111111111111111100000000110011010010000001111
101001110111110111111111111111101111000000000000000000000111
101001110000110000000000000000000000000001111110001111110001
101001110111110111111111111101111111111101111110000111011101
101000000000000111111111111101000000000000001110110111011101
101011111101110000000001100001110111111111111110100111011101
100011111101111111111101111111110111111111110110101100011101
111011111100000000011100000000010111111111110110101101011001
111000000000000000000000000000000100000000000110101101011101
111111111111111000000000000011100101110100000110101101011101
111111100000000000011111111011000101110100000000001101011101
111111101111111011011111111001000100000111110111111100011101
100000001011111011011111111010000000000001110000000101011101
111111111011111000000000111010001111111101110000000001011101
111111110011111011111111111010001111111101110111111001001101
111111110000000000000000111010001011111101110111111101011101
111111100100001000011111000000000011111100000000011101011101
111111100110101001111011111100010010000001110000000001011101
111111100110101000011000000000110111111101110000000000000001
111111000110101011011011111111110000011101000000000011111101
100001000110000011011011111000000111000001000000000000000001
110000000111111111011001111001110000010011111111111111111111
110111111111110111010011111001110000000010000000011111111111
110111111111110111000100000001110000111010000111111111111111
110111111011110000000000001001111000011000000111111111111111
110000011000000000011100000001111001111011111111111101111111
100111111000110000011100000001111000000011000000001101111111
101100000011111111011111111001111011101011111111000000000011
101111110011111111010110000000001011101000111111111111111011
100000000000000001010110001111100000000010111111111111111011
101111100000000000010110101110001111011010110001000000000011
1011100000000000110101101011111011E1000010110000000001110011
101111110111101111010000000111100000011000000000000000000011
100000010111101111010111000000000000001011111110000000100011
111111110000001111000000000000000000000011111111111110111011
111111111111111111111111111111111111111111111111111111111111
