111111111111111111111111111111111111111111111111111111111111
100000000000111111111111111111111000000000000000000000111111
1011111011111111111111111111110000000000110100000000000D0111
101111001111111111100001111110000011110001000000001111111111
101111000111111111110000000110010000000011001111101111111111
100011000111111111010001110110010000111000001111100000000001
111011000011110111010000110111010100000000011111101001111111
1000110000011001000000000001000000000000000D0000000001111111
100000001100000100000000000000100000000111111111110001111111
101110001111111100000001111110100001110111100001000001111111
101111001111111100111101111110101111110011101110000001111111
100000001111101100000001111110101111110011101110000001111111
111101110000000001110001111000001011110011101110010001111111
100001110110000000010000111111110011110011101110010001111111
111100110111111001110000000000000001010011101100000000000001
11110011011111100000000010000000000101000D000000000000000001
111000110000000001111100000111100001010101000001111100000001
1110000000001111111111D1111111100001010101011111111101011111
111011111110011111111101000011100001D10001011111111101011111
101010000000000000000000000000000000000001011010111101011111
101011111111000000000001110000001000000111011000111101011111
1010101111111011111111000001D1111D11000000000010101101011111
1000000000001D1110011111111100111011110111011000000000011011
11101111111010111000000D000001101010110100011011111110011011
111000000000101110111111110111101000D001110000D0011110011011
110000000000001110111111000111100111110000011111111100011011
111111110000001110000011E11111100000000111111111011100111011
111111111110101110000000000000000111100000000000011100111D11
111111111110101111111111111111111111101111111111011100000001
111111111111111111111111111111111111111111111111111111111111
