111111111111111111111111111111111111111111111111111111111111
100000011111111101111110000000000001111111111111111111111101
100000011110000001111111100000001111111111111111111111111101
101111011110111101111111101110000000111111110111111111111101
100000011110111000111111101100000110111011110100000011111101
111110011110111011111111101100000110111011110111111001111101
101110000000011000111000001101000000000000000001100000000001
101110111111100000111000111101011000000000000000111111111011
101110111011100000011001111101000000000000001010011111111011
100000111011111100011001111101110111110111011010111111111011
100000000011111000000000011100000111110111011010111111111011
10000000000D011000000000011101111111110111011010111111111011
111100000000000000001100000001111111110110011010111111111011
111100000000000000000111101101111111110010011000111111110011
111100111111110111100111101101100000000110011010000000010011
111100111111100000000011101100111101100110011000011111000001
111100111001110111110011101101000001101110000000010000011111
111100111001000000000000001100000001101110111100010100000001
111100000000000000000000001001111111101110101100000000011001
111100111001011111111111111100000000000000101100000001111111
100000111101000000000111111101110000111111101101111100000011
101100000000001001111111111101111110111111101101111111111011
101100011000001011111111110101111110111111000001001100000011
100100001111101011111111110100111110000000000101011111111011
100100000000001011111011110100000000111011110101011111111011
100100011111111011111011010001110000000000110101000000111011
110100000000000000011011010101110001000000010101011110111011
110001011111000101101000000100000001011111110101011110111011
100100011111010101101000000001111111011110110001000000111011
100100111111010101101111000011111111000010110111011110101011
1000000000010100011011110111111111110111101E0111000000101011
100000000000000000000000011111111011000000110100000000101011
101000000000000000001111011111111010011110000000111100101011
101011111111111111000000011111111010011110100110000000101001
101011111111111111001111000000000010000000100111101100101011
101010000000111111001111111100000000001111110111101100100011
101011011110011111001111111111100000000000110110000000000111
101001011110001111001111111000000100011111110000001111111111
100000011110011111001111111011111100011111110000000000000001
111111111111111111111111111111111111111111111111111111111111
