111111111111111111111111111111111111111111111111111111111111
110000011111101111111110000000111111111000000000001110000011
110111101111101111111110110000111111111110000000000001111011
110111100000101111000110111111110000000000000000000001111011
110000000000101011011010111000011111011111111110111101111011
110111111110100000011010111111001111010000000000001100000011
100011000000000000011010111000000111011111111110000000111001
101011010110111110011010111111100111011111100000011000100001
100010010110001110001000111100000000011111111100011000111111
111010010110110000001110111000000101111100000001011000111111
111010010110000000001110111111110000000000011100011000111111
100000000110111110001110000000000111110001111110011000000111
101111000110111110001100001100011111101101111110011000110111
101101000110111110011111101100000010001101111110000000000111
101101000010111110011100000001111010001100000000010001111111
101101000110111110010000000000000000000000111111011101111111
101101010110111110011110111111111110111100111111000001111111
101101010100110000001000110111000000111100111110000011111111
101001000000000011001011100101111110000000111110011011100001
101101000000000000000011100001111110010000111110011011111101
100000001100011111111111100000000010010000011110011000000001
110000001100000111111111100000111010010000000000000011000111
111111101100001111001110100000000010000011101101000010011111
111100001101111111101110100000011010011011101101110010011111
111100111100011111101000000000000010011000001101010010001111
111100111101111111001011111111111111000111111101010010000111
101100111100011111001011000000011000011011111101010010000111
100100111101011111001011010000000000000000000000000010100111
101100111001011111001001010111111110011111111111000010100111
101100111101011111001001010111111110001111100000000000000111
101100111100011111001000010111110111110000000000000001E11111
101100111100011111001011010111110111111101111111110011111111
101100111100011101001011010111110111101101100000001011111111
101100011100011101001011010000010100000000000001101011111111
100100011100000101001011010101110101110000111111100000000001
100000010000111100001011010000000001111111111111101011100001
110110000110111101001000000000111000000010111111101011100001
110100110110111101000111111010000111101110111111101000001101
110000110000111101110000000000111111100000000000000011111101
111111111111111111111111111111111111111111111111111111111111
