111111111111111111111111111111111111111111111111111111111111
101111111110111011100000111001110011111111000000000111110001
100011111110111011101110111001110011111111000000111000000001
111000000000000010000000110001110000000000001111111111111101
111000000111010000011111000000000000001111000000000000111101
111001111111000111000100010000010000101111111110000000101001
100001111111000111011111001101010010101111111111111111101011
111001111111000100011111011101001000101111111110000000001011
111001110111000100111111011101001000101100000001110000000011
111001110000000000111111011101001000101000000011000001111111
110001111110111100111110000100000000000000000000000000001111
101011111110111100110111100000000000000010001011111111111111
101011111100111100110110000000000010000000100000001111111111
101000000000111100110111101100000000000000101111111000111111
100011111111100000000000001101010011101000001111111011111111
101011111111111111110111111100010111000011111111101001000001
101011111111111111110111110001010111101011111111101101000001
10100000000000000D000000000000000111101011111101001101111101
100011111000000111101111110000010001101011000101001100000001
100000000000000000000000000010010000000000001101001101110001
101111111111101111101111111110000111110010111101000000000011
101111100000000001101111111110110100000010111100011110111101
101110011000000000001100001110110000010010111101111110111101
100100000011001111011011000010010110110010110001111000111101
100101010000000111001010011110110110100010110111111000111101
100101010000000001000000000000000100000010110100000000111101
100101011111111101001000001000000000000010000110111100110001
100000011111111100001011100000001100000000001110111100000101
100011000000000111111011100000000100111111000010000000111101
111111011111111111111011100000100000000000000000000000111101
100000011111110111110000000010101111111111E11101111010111101
100000011111110111110111000000000011111111110001111010000001
101111111111000000000011000000000000000110000001000001100001
101111100000000011110000011001111011000000000101111001101111
101110101111111111110000000001111011011100111100011001101111
101100101111111000000011111001111011000000000100011001101111
101100101111101000000000001001111011000111101100010001101111
100000101111101011110000000000000000010000000100010001100111
101000100000001000000111111111111000000000000100000000001111
111111111111111111111111111111111111111111111111111111111111
