111111111111111111111111111111111111111111111111111111111111
111001000000000011011100000000001111111111111111111111111111
111101000000110000000001000000001111111111101111111110000111
111001011111111101110111111111100001111111101111111110111111
111001011000000000000110001111100000111000000000001000000001
100000011111110111100110000000000000000001111111100000001001
110110011111000000100000011111111100000001111000000000000001
110110111111011111100110000000011111100100011110111101111101
110110000111011111100110111111110000001111011110000000000001
110110111100000000000010111111110000000000000000000000000001
110110000011011010000110000011110100000001111011100011111101
110110111000000000001111111010000110111101111011111111111101
110110111000111111111111111000010010111101111000001111111101
100110111110111101011111111111011010000001111111111111110001
100010111110000000000000000000011010111001111111111111111111
100010111110111101110000000000001000111001111111111011111111
100010000000110000010111111011101000000001111111111011111111
100010011100110000000111111011001001110111111111111011111111
100011000000111101100111000000001000010000000011111011001111
100000011100111101100110000000001001110011111000000011011111
1000110000000000000011111101E1101001110011101111111100001111
100111100000000000001101110000000000000011100000000011101111
110111111111110110101100000000000111111010000000000000001111
100110000000000100101100111111100000000011111000000000101111
100100000101100000100000000111100111110000000001111111101011
100101101101100110101100011111110111100111101111000001101011
100001101100000110001100001000000000000011000000011111101011
111111100111110010101111001011001111101011111000000011101011
111000000001100010101110100011100000001011111011111111101011
111000000000000010101100001000100000101011110000000000100011
101111111110000000100111101110111110101000111101111101000011
101111111000111111100000001110111110000111000000000001000111
101100000011110000000000011110000110101111111101111100000111
101110000011011111101110110000000000101111111101101100000001
101000000011011110101110111111101111001111111101101010111111
101000111011011110101100111111101111101111111101100010111111
101110111011011110100000000011101111101011111100000000000111
101110111000011110111111111011101111101000000001101111111111
100000000000011110000000000000000000000011111100001111111111
111111111111111111111111111111111111111111111111111111111111
