111111111111111111111111111111111111111111111111111111111111
111111110100000001101111101111111011101111111111111111100011
11101000000111000000001E000001111011100001100000000000000011
101011111101111111101111101101111001100000000001111111111011
101011111101111111101111101100000011101111111101111110011011
10101D110101111111100000001101111111101011111101111110111011
100011110101111100000111100000000000001010111100001110111011
101011110101100000110111100000110001000010000000000100000011
101011010101101110110000001110110011101000000100110000001111
101011010100001000011111111000110000000000110100000001111111
101011000101111110000000001110000001111100110100111111111111
100011010000001111111101111111110001111100110100111111111111
111000000001111111111101111111110111000000000000000000000111
111011110011111111000000000000000111011111111001111111110011
110000000011110000000000000000010111000000011001000000000111
111111110000001111111000000000000111111111011001100000000111
110110110000001011111110011111111111111100011001101111100111
110010111000000001110000001000011101111111011001101111110111
100000000000111100000000000000000000000000000000000011110111
100001111000000000011111111111111111111111111100000111110111
100111111001111011000111111100101110111111110100001000000111
100000000001111000110111111001100000101111110100001111110011
100011111001111011100111111101001110101111110000001111110111
100001000001010000000111111101001110100011111111111111110001
100000000001010000000111000000001110101011111111111111100001
100111000000011111100000100001101110101011111100000000001001
100000000001011111101111111100101110001000000001111011101101
101111111000011111101111111100001110001011011111110000001101
1000000000000011111011111111D0000110001011011111110111000001
111111111111101111100000000100111000000001000001110000000111
100000000000101111100111000000111111001100011000000111011111
111111100000000010000111001100111111000101011000111111011111
111110101111111111000000001100100000000101011010111111011011
100000101111111000001111101100111100000100000000000000011011
111100000000000000001111101100111000000000000011000000000011
111100000000001011100001100100000001111100001011100011110011
111000000000000000000000000011111101111111111000111111110011
111000011111111110000001000000000001111111111011111110000011
111000000000000000000000000000000001111111111000000000110001
111111111111111111111111111111111111111111111111111111111111
