111111111111111111111111111111111111111111111111111111111111
111111111111111100111110000000100000000000000011011111111111
111111111000000000000000011110111110111111111011011111111111
111111111110000111111111100000111110111111000000000000011111
111111111100110100000000000000100000110111011111111111110111
111111111100110111110000000001101110110111011111111111110111
111111111100110111000000111001100010100000000011111011110111
110001111100000000011110111101100000101111111000000011010111
111100000000011100011110000001111111100000110000000011010111
111101110000111111011111111100000000000110111111111011010111
111100001110111011000011111101111000000110111111111011010111
110001110000000000000000000001111111100110110000111011000111
110100111011100000000000000001000000000110110000000000000001
110000111000001110000111111111000111000010111110000011111101
110000000011111111010000000011011111011100111011111011111101
101111000011111111011111011000000011011010000000111011111101
101111011111111101011111011111111011011010111111111011111101
100111011111000001011111011111111011010000001101111000011101
1001110000110001010111110000111100000000011E1101111011111001
100111011010000001011111000000000111111111111100000000000001
100111011010111111011111011111100111101111111111110000000011
100000011010000011011111011011100111101111111111100000001011
101100001010100111011011011011100111101111111111100000000011
111111100010100111011011011011100111101111111111100011111111
111000000010100000001000011011100000001111111111111011111111
111011111010100111001111011011100111111111111110000011111111
111011111010100111001111011011100000000011111111111011111111
100000000010100111001000000000000000111110000000000011111111
111011101000000000001110111111101110111111111111100011111111
100011101011110011001110111111100110100001111000000011111111
111000001000000000001010111111100110110000000011111011111111
111111111011111111001010100001100110111000000000000000100001
111111111011111111001010111101100110111110000000100000000001
111111111011111101001010011000000000111110011101111000111111
110000011011111101001011011010111110111110011100000100111111
110000011011000000001011001000001110011110000000000000111111
110000000000000000101000001001101100000000011111111000001111
100111000111101111101001111001101101111111111000001011101011
100001001111101111100001111000001101111111111011000011100001
111111111111111111111111111111111111111111111111111111111111
