111111111111111111111111111111111111111111111111111111111111
100000011111111111111111111111111111111111000000010000000111
100000000001111111111111111111111111111111000001110001011111
111111101100000000111111111111111111111000011111110101011111
110111101101101110110001111111111111100000011111110001011111
110000000001100000010100001111110111111111011111111101010111
110111111101111111000111111111110111111111010000000000010111
110111111101111110000111110000000000000000000000000001110111
110001111101111111100001110111110000111111110000000001110111
110111111100000000001101110111110111111111100000000011110111
110110000000001111101100110111110000000000000111111011110001
110010111111110000000110110111110111111111111111100010000101
110010111111110000001110110111110000000001111111101011110101
110000001111100000000000000111110011111111111111100011100101
110111111111101111111110110010000111111111111111100000000101
110111111110001111111110100010111011111111111111110011111101
110111111010111111111110111010000000000000000000000011111101
110100000010100000111000111011000000010001110000110001111101
110111111010101110111111111011010001011101000000110000000001
110111111010101100111111111011000000011101111110110111111111
110111111010000000000111111000011111111101111110100111111111
110111111010001110111111111111100011111101111110110111111111
110111100010101110110000000000101111111101000000010111111111
110111101010100000000101110000000001111101111000000000001111
110111100000110000110101111111011111111101110010000000001111
110111101110111110000000000000000000000000000011111000000001
1001000010001111101111111111111100111E1111110011111000000101
110100000000111110001110000000000011011000000011000011110101
110000000000111111101111110111111011011111000000000011110101
110011100010000000000000000000011011011111111110111100000101
110000000010111111101111111111111011011111111110111100110101
110011111010000000001110111111011011010001100000000000000001
110000000001110111100000000000000011011101111111111101111001
100000111101100000000001111111110011011000000011111101100001
100100111101110111110000000000010011000000111011111101100101
100100111101110111111111111111110011011100000000000101100101
111100111000000111111111111111110001000000110111010001100101
111000111011000011111110000000110001001110110111010011100101
111000000000000000000000111111110000001110000000010011100001
111111111111111111111111111111111111111111111111111111111111
