111111111111111111111111111111111111111111111111111111111111
111101111110111111111000000000000000000000011111100000000001
111100000000000000011011111111111011111111111000000000011101
111101110100000001111011111111111011111111111000000011111101
111000000000100000000000111100000011111111011000000000111101
100000111110000001111110111111111111111111011011000000000001
111110111111111001101110111111111111100000000011111111111101
100010111100000001000000000110000001101111111111111111001101
10001010111111000111111111111101E101100111110000000011100001
100000000000000000000000011111011101010100000000111100001101
101111100000000000000011111111011101010101110111111111101101
101111101110000000000011111111011101010101110111111111101001
101111100110110111111011111111000000000101110101101111100011
101100000000000000000011111111001101011100000100000000000001
100111011110000000110000000000000000011100000100111100000001
100000000000000001100000000000011111111100000000000000000001
100011111000100000110000000011111111111101111110000000000101
111111111011101111110000111000000000000001111000111100000001
100000000011000000001110000101111111110101111110111111111001
110000001001111100000000111101100000000001100000111111111111
111111000000011101111110000001000000011110000000111111111111
111110000000000100111100101110110000111110001011111111111111
100001111111110100000000101110110000000010001011111111110111
101111111111100001111110101110110111111100001011111111110111
100000000000000101111110101110000011111110011000000000010111
101111111000100001100000100001110000000110011111111111110111
101000000010111101001110100001111011111111111111111111110111
101110000000111101001110101111111000011111111111111111110111
100000000000011101001110000111111011100000000000001111110111
110000111000000001001000100000000000101110000000001111110111
110000011111110000001110111111111110001110110000011111110111
110011011101110010000010111111101110100000000110011111010111
110011011101110010111010111111101110101111111110011111010011
110001011000010000000010111111001110000001011000001111010011
100011011011000110000010110000000000111000011110000011010011
101011010000000111100010110111111110111000011111111000010011
101000000000000111100110110000000000111000000000010000000001
100001111111100111101110110000011110111000000000000000011101
100111111111100000001110000000000000111000000011100111111101
111111111111111111111111111111111111111111111111111111111111
