111111111111111111111111111111111111111111111111111111111111
10000111111111E111111111111111111100111000000111111111111111
100001111111100000000000001111111100111000000000111100001111
101111111111101111111111111111101100100011111111111101111111
101111101111101111011111111111101100000011111111111101111111
100011100000001111011001111111100000001000000111111100011111
101111100111111111011001111111101111111000000011111100000011
101100000111111111011000100000001111111000001011111000001011
101000000001100000000000001111000000000001110010101011111011
101010000111000111111101100000011111110000000010101011111011
101010111111011111100001101111011111110101110010000010000001
100010000000011111111101100011011111010001110010100110111101
100011111111100000111101101111000001011111110010000110111101
111111111111101110111100001111000011010000000011110110111101
111111111111100010111111100111000000011110001000000000000001
111111111111111110111111100011011111110111111011111011111111
111011100001111000000001111000000011110111111000110000011111
100011101110000001111111111110001010000000001011110110111111
111011001101111011100000000000101011000000101011110110000001
111010001101111011110000000000000000000000001011110110101011
100010101000111011000000000011110000111000000000110110101011
101110100110111010000000111011000111110001110111110110101011
100110101110111011111111111011000001110000000111110110101011
100110101110111001111111110000000000000001110000010110101011
100000001110111000000011110000000011111111111100010110101011
101111101110100011111111110000111011000011111100010110101011
101111101110111000001111111110111000111000001100000110101011
111111101110111111101111111110111010111111100011111100000011
111011101110111111000000000000111010111000001011111111100111
111011101000101111001111111111111010000001111011100000000001
100011101110101111000111111100000011111100000011111110000101
101011101110101001000000011111111011111100000000000000000101
100000000000101000000001001111111011111101000000000001011001
101111111110101011100001001111000011111001110101110000000001
101111111110101011111100001111100000111000000000010000000011
101111111010101000000001000000000000111000000100000111101011
101110111010100000001100000000000010111010000100110111101011
100110000010000000001100111101111110000000100000110111101001
100000111000000110000000111101111111111110000000000000001101
111111111111111111111111111111111111111111111111111111111111
