111111111111111111111111111111111111111111111111111111111111
100001101111111111011111111011111111110000000000000011000001
101111101111111111010111110011111111110111000000000000000001
101111101111111111000111110011111111110111011111111111111101
101111100000110000010110000010000011110100011111100000000001
101111100001111111000111100011011111110110000001111110000001
101111100011111011011111100011010000000000011101111111100101
101111101111111000011111100111000000000011000001111111100101
101111101111000000000000000111111011111011000000000111100001
101111101100000000011111000111111000000010001111110111100001
101111100000000000000000000111110001100000000000000111101111
101111110000000000011111000111100111101100000000111111101111
101110000000000011111111010111100111101111011110111111101111
101110111111111010000000010111100111101000001110111111101111
100000000000000000000000000000000000001111001110111010101111
111110111111111111111000000000000110111000001110111010100111
101110111111111111111000000000000000111111000110111010101111
101110111111111111101011111111100111100000000000000010101111
101000000000000101001011110110000000000001100000110110001111
100111110000110000000011110110000001111111011100000111101111
100111101100000111111011110010111111111111011100110111101111
100111101100000111000000000000101111111111011100110111101111
100111101100110111000000111111101110111110000000010000101011
100110000000000000011111110001100000001110111100000101101011
100111111101101110000000000111101101111110110000000101101011
100111111100000111111111100000001101111110111101100101101011
1000000001011110000000111011011011011111E0011101100101100011
101100000101111011100000000001100101100000011100100101111011
101111110101110000001110001111101100000010011100100101000011
101111110101111111110011101111101101110010011100000000100011
100011110101110000000000001111101101110010000000000000000011
111011010100000000000000000000101101110010111111111111000011
111010000101111111111111101111100000010010011111111111000011
111011110000111111111111100111100101100010101000000000000011
111011110000000011111111100111110101111010101011100000001011
111000000000000111100000000000000001111010101011110000001011
111001111000000000101111110111100001100010101011110000000011
111001111001111010101111110111111101111010101011110011111111
111000000000000000001111110111100000000010000011110011111111
111111111111111111111111111111111111111111111111111111111111
