111111111111111111111111111111111111111111111111111111111111
111111111111111111111111111100000000011111111111001111111111
100000001100000111100000000010100000010000000000001100000111
101000011101111111111111001010100000000000000111001111110111
101111011000000001111111000000101111111111110000001111110001
100001011000000001111111011111101111111111100011001111111001
111111011011100001111111011111101000001111100011000000000001
111111011011111100001111000000001110001111100111011111111001
111111011011111111101111111111101111101111110111011111111001
100000011011111111100111111111100001101000000001000001011001
100000111010000011100000000000001101100000000000001111011001
101000000010111111101111111111111100000000000001101111011001
100011111110101111101100011110011100111111110000001111010001
100000000010100111101100000011011100111111111111101100011001
100111111000000000001100E11111011100100000000110000001111001
100000001011111110000100000000000000111101110111101101111011
101111111010000000000100000000000000001100000111101100000011
100000110010100000001111111100111101100100000001101111111011
100000001010101110000000000000111101000100000011000000010011
101111100010101011111111111100111001000101111111101111110011
101111100000000001100000111100000100000100000110001000110001
101111101111111100001110111101011111110101110000111011110001
101011100011000001111110000000000000000101110000111000000001
101011101110000000000011110111111111100001110110111111111111
101011101111101111101000000111111111111101110000000001111111
101011100001101111100011110101110000000100000001111111111111
100011101100001111100000000001110000000001111100001110111111
100000001101101111100011111111111100000001111101101110111111
110110000001101111100000000111111101111111100001101110011111
110111111100000000000000000111111101111111101101101110000001
110000000011111111111111110000000000000111101101100110111101
110111111110111111111110110111111111111111100001100110110001
100000000000111111111110110111100000000001100000000110111101
100000000000111111111110110111111111111011111110000110111101
111111111110000000000110110000011100000011111110000000111101
111100000000111111011110111110011100011000000000000000001101
111111111110111111011110110000011100000001111111111100001101
111111111110001111000000111110001100000000001111111111100001
111111111111100000011110000000001100000000011111111111111111
111111111111111111111111111111111111111111111111111111111111
