111111111111111111111111111111111111111111111111111111111111
111000000000000000000000000000000111111100000011110111111111
100000000000000000000000000111110000000000000000000000001111
111111111111110000000001011111110111111100111111001111111111
111111111111110000000000000000000110000100111111101110000001
111000000001110000000000001000000000000000001111101100001101
111100D00100000000001111011111000000011110100000001101111101
110000000111110000000000000000111111011110001111100000111001
110000000111111110111110111111011111001010100000000111000011
110101000111111110110110000000000000001010100111100000111011
100101110111111110010110111111111111101010100000000010111011
100000010011111100110110111111111111101010100111010000000001
100000000001111100110110111111100000001000000000000111110101
111111111101000000110110111111101111000000110001110111110001
100011011101111110110100111111100000000000000101110111110111
100011011000000000110100111111101111110111111101110110110111
111000000000000011110100111110101111100000000001110110100111
111011111110000011110100111110101111100000001000000010110111
111011111111111011110100111110101111100000000000000010110001
111000011110111001100100111110101111000011101000000010000001
111011110100011011000100110000100E11000000000000000000000011
111011110110011001000100110000000000000000011011110000111111
111011110111011011000110111111101111011111110000000010000001
101011110111011000000000000000001111011111110011100010011101
101000000010001011000100000000000111011000000011100011000101
101011100110000011000000000101100000011010000011100000000001
101011100110000000000111111100000001011011000011000000111101
101011100000000111111111111100000001000011000100011110111101
101000000000000001111100000001110100011110010000011000111101
100000000000000000000111000001110101011110000000000110110001
101000100011111111110111111101110101011110000000000000000001
101000111110000000000111111100000000011110000000000000111111
101100000000101111110111111100000000011110000000000011111111
101100101000000000110111110101111010011111111111111111111011
101100100110101100000110000001111010000000000000000000000011
100000000000000000000000000001000000000000000000000000000011
111100000000000001110111111100000000011110111111111111111111
100000000000000000000011111101000000011110000000111111111111
101111111111111111110000000001111000011110111111111111111111
111111111111111111111111111111111111111111111111111111111111
