111111111111111111111111111111111111111111111111111111111111
111110111111111111111100011111000000000011111000111111000001
111110000110000000111100000000011110111000000010101111011001
101110011000001110111100000000011100111011110000101111001111
101110111110101110000000000111111100111011110010000000001111
101110111000001110111100000000000000111010110010111111101111
101110111011111110000001000100000000000010110010111000000001
100000000011011110111101010100000000000000000000111101111101
101000000011000000111101010111111111111111111000111101000001
101100100000001111111101010111110000010111111110111101111111
100100100001101111111101010111110111110111111110101101111111
100100100100000011111101010000000011110110000000101100000001
100100100101111111111100011111111100000010110001101101000001
100000100101111111111101100000000000000010111111101101111101
111110100000000100000001101111111111110010111100000000111101
111110100101111100000011100000000000000000111111111011111101
111110100000000000000111101111111111111110111111011011111101
111110101110000100000000000000000000000110001111011011111101
111110101111111101111111111011110000000111100000000011111101
101110001111111000000000011000001111110111000000000011111101
101111101111000011101111011111111111110111010000000000111101
101111101111111011101111011111100000000011001111011111111101
101111100000011011101111011111101100000111011000000000000001
101100000000011011101000000000001111110111011011010000100001
101111111110011011101111111010001111000000011000000100111101
101111111000111011100000000000101111110111111000001000000001
101111111110000000100000000000101111110111110001111000110001
101111111111011110111111111110100000000111100001111000000001
100000000000001110000000000110111111110000000001110000000101
101110001111000000000000111110111111110011111001000000110001
101111101100000000000000001110110000000000000001111110110101
101111100000000010111111111110000111110111000000111110110101
100001101111111010001101111111110111110001111100111110110001
11011110111111100010010100000000011111011111E100111110111001
110100001111111000100101111000010000000111110000111110000001
110100110000001000100101100010000000110111101100111110100001
110000000001101000100101111111000000000111100100111110111101
101111111101101000100100000111011110110000100000100000000001
100000000001100000000000011111000000000111100000000000000001
111111111111111111111111111111111111111111111111111111111111
