111111111111111111111111111111111111111111111111111111111111
111111111111111111111111101000000000000000000000000000000011
100000000011111111110000000001000000000110111000000111111111
100000000000000000000110000000000000000010000001111111111111
100001111000000011010110000000000000111010011000000000000111
111000000111111011000110111011111111111010011111111111110111
111010000001111000000000000001111000000000011111111110110111
111011111100111001111111011001111111111100011111111000000001
111011111100111001111111001101111111011100011000000011111101
111011111100111000000000011101101110011100011111111011111101
101000000000111011111111000000001110011101010000000001110001
101111011110111011111111001111111100000001000001110001110101
100001011110111011111111000000001101011111111100000001110101
110011011010100011100000011110001101011111110000111000000101
110111011010000011111111011111101101011111111100101000000101
110111011000111011111111011111100000011111111100000111100101
100100000000111010000000000011111111111111111101110111110001
110100111100100010000011111000001111111110000000000000000111
110100111100000000000000111011111111111111101111111111111111
110100110101111111111110111000001111111111101111111111111111
110110110100000000001110111011111000000000001E10000000001111
110110110111111110111110111011111111011111100011111011111111
110110100111111110111110000011111111000000000011111011111111
100110110111100000111110111111111110011000111011111000111111
100000110011100000000010111001111100000100110001111011101111
100110110111000001111110111001000000000100110000101011101111
101110000000000000000010111000111111110100000000000011101111
101111100000000000000000111000111111100101100011101111101111
100000001011111011111111111000111111100100000111101111001111
111100000000000000000000000000110000000101110111100000001111
111111100100000000001111000010000000000101110110101111000001
100111000000011011101100010010111011001100000000001111000001
100110001111011011101111010010110011101111110000000111011111
100000000000010011100111010110111000000111110111000011011111
100010001000000000100111010110111000000111110111111011011001
111110111011110110100111000000011001100000000000000000000001
111110111011110110100000000001000000001000000000000000000001
110000111011110110100111111100000001111011111111111111111001
110000000011110110000111111100000000000011000000000000000001
111111111111111111111111111111111111111111111111111111111111
