111111111111111111111111111111111111111111111111111111111111
100000011111111111111111111100000000001100001111101111111001
111000011111011111111111111101111111111101111111101111100001
111100000000000000011111110000011111111100111111101111111001
100101111111111011100000111111000001111000111110000111011001
10000D000000001000000000000000011101111000000000110111011001
111000000000000011111111110000011101101000111110110011011001
111100000000000000111111110000000001101000111110110000011001
11111111D110001100000001110000111101100001000000110111000001
111110111111111101111101110011111101101100000010110111001111
100000001111111101000001110000011100100001110000000111011111
101011111100000000011100011111011101110001111000011111011011
101011111111110111010000000000011101100000000000010000011011
101011111111110110010111110000000001101111111110010011000001
101011111111110110010000000100000001101110111110010011110001
101000000011110110010000000000000000001110011110010011111101
101000000001110110010011111111111000000010111110010011111101
111011100000000110011111111111111011111010000000000000000001
111011000111110110011111111111111011111010100000100000000001
110011100111110000011000000000000000011010111110100000111101
110000000001110111000000000111011001111010111110000000001001
100001111100000110000110110111010000000010111110011111111001
110111111111110100011110110000010001111000000010111111000001
1101111111111101000110101100011100011101111110101E1111111001
110000001111110100000000000001110001110111111000001111111001
100011101111110000000000111000000000110111111010111111111001
100000000000000000001000111000111100100111111000001111111001
100000001110000000000011111000111000000111101011101111111101
100111001110111111111010000000001010000111101011101100001101
100111101110001111011011111101101010000000101011101111101101
101111101010000000000011111101101000001000101001100111100001
101111100000000000011011111101101000011110101011100000001101
101000000000111000000000011100101011011100000011101100001101
101111111110000001111111111101101011000000000000101111100001
101111111110000001111111000000001011111111010000001111100011
101111111110111111111111000001111011111111000000001111100001
101111111100111111111101000100011011000111000000000011110001
101111111001000001110000010111000011000000011111111111111101
100000000001111100000111000000000011000000000000000000000001
111111111111111111111111111111111111111111111111111111111111
