111111111111111111111111111111111111111111111111111111111111
100111111111111111011111111110000011111000001111111100000001
100111111111111001011111111111111011011000010000011100000001
100000000000000000011110000000011011001011110000011000100001
100111111110000000011110100000000000011000000000111001111101
100000001111101110011110111101110111011111111011111001011101
100110000000001110011110000101110111011111111000000001000001
100E11110001111110011100110101110111011111111011111111011101
100111111101111110011110110101110111000000111011000000010001
100000111100000010000000110001110000011111111001011111011101
111111111100111000000000110000000000000100000011011111011101
111100000101111010000000111111110000000111111000000000001101
110001111100111010111110111111111101011110000001111111110101
111101111101100010111110111111111100011111000001100000000001
100000000001111010111110110000010001000111011111111111111111
100000000001111010111100110100000000000011011111111111111111
100001111101111000000000110000011100000111000001111000000001
100000000100000000000000110111111100111111011111111001111001
100000000000000100000000110000001101111110001011111001110001
100000000111110111111110100111000001000000100001101001110001
100000000100000000001110000100010000011110100011101001110001
100111110101111111101110000111000000000000001111000001110001
100111100001111111101110000110110000000111000111101100110001
111000000101111100000000000110110011110111000111001101110001
111111110101000011100000011110111111110111000000000000111001
111111110101100000000000000000000000000111001111000000111001
111000000101101111100011000001111111100111001111011110000001
111111110100100011101000000001111100000000001111000000000001
111100000100001011101000000000000001000000111111011111010101
111111100101111011101011111111111111000001111111011011010101
111111100101111011101000000000000000000000000001011011010101
111111100101111011100000000000111110000000000001001011010101
111111100100011010100011111110111110111111000000001001010001
111111000100000000000011000000011100101101110000001101011111
111111000111100111000011111011011110101101110110101100011111
111111000000000011111111111011011110101101110110101101000001
100111000111100000000111101000011000000000110000001101000011
100000000100000001111011101011000001100000000000000000000001
100000000001100000000000000011000001111111111111111111111101
111111111111111111111111111111111111111111111111111111111111
