111111111111111111111111111111111111111111111111111111111111
111110110000000111111111111110111000001111111110000000111111
111000000100000000011111111110111010000000111100111111111111
111000000101111111000000000110110011110111111100001111111111
111000000100000000111111110110111010000111000000000000001111
111111110000111000111011100110100000000011011100111110000001
111111100000111010000000000110111111111011011100111111111111
100000001000111010110111110100000011111000011100111011101011
100111101100000010110111110101111011011010000000111000001011
111111100111110000110100000101111011000010011110000001101011
101101100111110111110111110101111000000000000000111000001011
100000000001110111110110000101111111110011110000000000001011
101111110000000000000000000100101111110011100000111111001011
101111111110100011111111111100000000100000000011100000000001
100001111110110111101111111100000000001110111111111101110101
111100111110110111100000000000000000001110000011111100000101
111101111110110001100111111101110111100000011111111011100101
111001111110000001100000001101110111100001100010111000000101
111001111111110001100000000101110111100110101110111111100101
111000000000000001100111100001000000000000001110111110100101
111000000000001000100000111101010111100001101110111110100101
111000000011000000000111000000000110000001101110111110100101
100001111111011111111100000101000000000001101110111110100101
101100000000011111111100011100110000000001101110001110100001
101111101111111111110101111100000000000000001110001110100001
101111100000000011110101111111111111111111101110001110100001
101111101110000000000100111111111111111111101000000010100101
101100001000100000111101101111111000000011000000111010100101
100000000010101101110000000000000000000011111110111010110101
101111111000100001110000001000000000001011111110111010010101
101111000000000101000111000000000110001011111110000010110101
101111111111110101110000000111110111100011111110111010110101
101111110000000101110101111111110000000001E00000111010010101
101111111111110101110001111111110001011101111111111010000101
100001111111110101110101111100000111011100001111111010011101
100111111110000001110100011101011111011101110000000010011101
100100000000000001110000001100011111011000010111111010011101
100101111111111111110111101111110000010000110111111000011101
100000000111111111110111101111111111011110110000111000000001
111111111111111111111111111111111111111111111111111111111111
