111111111111111111111111111111111111111111111111111111111111
101111100000000000000001111011111011111111111111111111101011
100011111111101101111111111011100000001011011111111100001011
100000000000000000000000111011111111101011011111110001101011
111111111011111101111111111000000011100000001100000001101011
111000000000000000000000000010000111111111100000001111100001
111111111011110000000000111010000100000000001111111111101101
101111111000111111110011100011000100111101111111111010101101
100000000000111111110011101110011100000000001011111010101101
111111111110111111110011100111011100111111111001111010101101
111011111110111111110011100111011100000000000000011010100101
111000000000111111110011100110000001101111111111011000100001
111000000000000000000001100111110000000111111101011011000111
111010000000011111111111100111111101E00111111101011011100111
110010110110011111111110100111111101100001111100001011100111
100010110110011111111010000111111101100000111111000000000111
101010110000010000000010000111111101111110111000000000001111
100010111111000000110010000000000000000000111001000001100001
101010111111111111110010000000000001111011110001111111101111
101010111111111111110000000110000000000000010001111111000001
101010111111111111110010110100000000011110011001111111111101
100010101111111111110010000111111111000001011001111111011101
100010101111111111110010000000000001001111011001111000000001
111110000000000000000000000111110001001111011001111011111111
111110111111110000111111000000000001001111010001111000000001
111110000111110111111110000000111100000111010000111111111101
111110111110000000000000000001111100000000000000000000111111
111110111111111111100111101011111100001101100001110111011111
111110111111111111100111100011111100001101100001110111011001
111010111110000000000000100011111100001101100001110000000101
111010111111001111111100000000000000011101100001100011110101
111010111111000111101100001111000000000001100010000011110101
100000111111000000001111101111111111100000000000000000010101
101111000000000000101111101111011111100000000000111101010101
101100011111101111100000001011011111101011111111111101010101
101110011111100001111100111011001100000000000000111101000001
100000000000001111111000111011000000001111100010011101001001
111111000000001111011000111011001111101100000000011101001001
111111000111100000000000000011001111101111111110000000000001
111111111111111111111111111111111111111111111111111111111111
