111111111111111111111111111111111111111111111111111111111111
100011111111111111111111111111000001111000000111111011111111
100001111111111111110111111111101100000011000011111000000001
100000011111111111110111111111100001111110011011111000000001
111000000000011000000000000000000001111111000000000000000001
111011111111000000100111111101101100000000010000000001111111
111011011000000000000100011101100011111111111111101111111111
111000001000000000000000000000001011111111111000001100000001
111011000011111111100000000001000010001111111000001101111101
111000000011111111111011101100000000000111111000100001000001
100000001111111111111010100000000000100111111001111001111111
110001000000000111111010100000000111100111100011111001111111
110000000010000111111010101111111111100111100000000000001111
100111011010011110000000101111111111100111100000111111101111
100111000010011000000000001111111110100111100000001000000111
100111011000011111111011000001111010100000000111110001110111
100001010001110000000011011011111010101111110111110111110111
100000001100000001111011011011100010101111110000010111010111
101000001101111101111000011011101110100000000001110100000011
100011111101111101111011111001101110111111110011110101111111
100000000001111100111011111001101100111111110000000100000011
111000000000110110111011111001101110111111111011110100000011
111000000000110110111011111000101110000000011011110100000001
100000000001100110100011111000001110000000000011110101101001
101111011111100110111110111111101100011110000000000001101001
1000000001111001101111101111111011E0111000000110000001101001
100000000001110010111110111111000000001111110000000001101001
101111011100010010111110111111001111101111110000000000000001
101111000000010010111110000000001111101111110111010000000101
101111100000000000001111111100000111101111110111010111111101
111000001111111111111111100000000001100000000000000111111101
111111101111011110111111111111100000000000011111110111111101
111111000000000000001111111101111111111110011000000000000001
111111001110000110001011111100000000000010011001110110111111
100000001110001110001000000000111111111110011001110000000001
100000001110001110001011111000111111111110011001111111111111
101101111110101111001011111000111111111110011000111111111111
101101111000101111001011111000000001111110011000000000111111
100001111110000000000011111000011111111110000000000010111111
111111111111111111111111111111111111111111111111111111111111
