111111111111111111111111111111111111111111111111111111111111
111111011110000111000000000000000D00000000011111100000000111
111111011110111000001000000000001110000000000010001111110111
111111000000111111000011111111000010100000000010000000000111
100110000000010000001010111111111000000000000110111101110111
100000001110110111101010111E00000001111111110110011100000111
101110110D00110101101000111100000001111111110100011101111111
1D1110111110000101000000000000000000000D01110000011101111111
101110111111000101000111110000000000111111100000000101110001
101100101111100101000111110110000000000000111110000101111101
10110000111110010D00011111011011111101111011111001100000D001
101111100000000011000111110110111111D11110111110011011111101
101111100000000000001111110110001111011110111110000011111101
101111101100011011101110000000001111011110111111111111111101
101111101111001011100110111111100000000000000001111110000001
100000001111000000000010011111111111111111111111111110000001
100000000000000000000010011111111111110000000000111110111101
100000000000111111110010000000000011110111111110111110111101
1110111110100000000000100111111111100D0001110000111110000001
100010000010011111110010011111100010111111111100000110011101
100000001110111111110000011111110010111100000001111110000001
10101111111000111011001000000D001010110110000101111000111001
1010000111111011101100100011111D1010000000001101111011111001
101011111111101110000000001111101011111100101101111011000001
100011111111101110111110001111100000000110101001111010000001
1010111111111D1110000010000000000000000000000000011010000001
101011111111100110111110000000001111111110111110000000000001
101011111111100000001110001111101111111110111000000000001001
101011111111101111111110001111100000000000111111100011111001
111111111111111111111111111111111111111111111111111111111111
