111111111111111111111111111111111111111111111111111111111111
1D0001111111100000000000000000000000011111111111001111111001
101100000000101011111111111111111011111111110111001111111001
101101101111101011111111111111111011111111110111000000111001
10000110111110101111111111111111000000001111011E010000000001
101110000001101011111111111111111111101000000000011111100001
101010111111101000000001111111111111101011111110011111101101
1010001D1111100000011101011111111111101000000000001111101101
101000111111111111011101011111111111101111111110001111101101
100000111111111111000001011111111111101111111110001111101101
101111111111111111000011011111111100001100000000001111101101
100000000000000001000011010111111000001100111111001111100001
101111111111111111010110010111111011111101111100000000000001
100111111100000111010110010111111000111101100000000000000001
101111111111110000000010010111111011111100000000000000000001
100111111111110111011110010000001011111101111110000000000001
100111111000000111001110010111111001111101111110000000000001
100011111111110111000110010111111001111101111111111111110001
100000000000000000D00000010101111001111100000000000111111111
101111111111111111111111000000000001111111111111110111111111
100111111111111111111010111111110001111111111111110111111111
100000011110000001111010111111100100111101111111110111111111
111111100000111111111010011111110100001101111111110111111111
111111111100111111111010111111110100100001111111110111111111
111111110000111111111000111111110110101101110111110001111111
111111111110111111111011111111110110001101110111111000000011
111110000000111111111011000000000010111101100111111111111011
111110111110000001111011111111110010111101100111111110111011
111100000000000000000011111111110010111100000001111110111011
100001111101111111100011000001110010111100000000000000111001
111111111101110000000011111101110010111000011111000000110001
111111111101111111111011111101110010111011101111111110110111
111111111100000001111011111101110000111010000000000110110111
111111100000001111111000111101110010000000000000001110000111
111111101111111111111011000001110000001110001011101110110001
110000000001111111111011100000000111101110111000001100111101
111111111101111111100011101111110111101110111001101101111101
110000000001111111001111100111000111101110111001101101111101
111111111100000000000000000000000000001110111001100000000001
111111111111111111111111111111111111111111111111111111111111
