111111111111111111111111111111111111111111111111111111111111
111111111111111000000001111111111111111111111000000011111111
100000000111111011111000000000000000000000000011011111111111
101100000000000011111111110000000110000010000010000000111111
101001111111101011111111111111110111110010111111101110111111
100001111111101011111111111110000111000010111111100000000001
111001111111100000000111111111110111110010111000001111111101
111000000011100000110111111111110111110010000000000000000001
111101111111000001110111111111110111111000000001111110000111
100001111111000011110000000000000000111011000001111110000111
101111111111000111111111110000000000111011000011110000000111
101111111111010111100000000011111111111000000000011011010111
101100000000010111111110000000111111111011000000011000000111
101101111111110111111111011000000000000000011111011000000111
101101111100000110100000000000111101100000111000010001111111
101101111101111110111111111110111101111011111011010111111111
100001111101111100111111111110111101111011111011010000011111
101111111100111100111111111110111101111011011000011111011111
101111111101011100000111111110111101100000000000000111011111
101111111101011100000000000000000000000101111111111111010011
101111101101011100111111111111111111011101000000000111010011
101110000001011100101100000001110000011101011111111111010011
101110110001011100100000000101000011111101001111111010000011
101110011101011100101101111100000000000000000000000010100011
101000000000011100101101111101111111111111111111111010100011
10111100111110000010000001110000000001111E111111111010100011
101111011111111110111110000001110000000000000111111010100001
101111011111111110111000111101110111111100000111111010000111
101111000001111100001011111101110111111000000101111010000001
101111000001111101101000001101110111111111100101111010011111
100000011101111101101010111101110000111111110101111010001111
111111111101100001100010111100000000111111110001111010011111
111111111101101101111110000000011110000000000000000010011111
111000000000000000000001111111011010011111110000000000011111
111111111000000001111110000000011010011111011111110010011111
111000000000001101111110111111011010011111011111110010011111
111010111111111100011110111100000010011110000111110000011111
111000000000000000000000000000000010011100000111110010000001
100000001111111111111111111110000010000000000111110000001101
111111111111111111111111111111111111111111111111111111111111
