111111111111111111111111111111111111111111111111111111111111
111111111100000000000000000000000001111111111000001001111111
111111110001E11111111011100000000001111111100000001001000001
100011110111111111101000000000001101111111111101000001011101
100011110110111111101000000000000101111111111100000001000101
100010110110111111101001000001100000000000000000000000000001
101010110100000000000001111101101100111111000000000000000001
100000000101111111111111111101101100110000000001110000001101
111111111100000000000000000000001100000000000011110111111101
111111111000000111111000000010100001101011011011110000000001
111110000011110111111011111000000011101001000011110111111101
111110111011110111111011110011110000001011111000000011111101
111110000011010110100011111000000011111011111110101000001101
111111000001010010111011111111111111110000000000001011111001
111100000001010000000000001100000000000000000001101000111001
111111111101010000111111111111111000000001111101101110110001
111100000001010000111111111111111111111001100000001110110001
111111110111010110000000000000000011100001111011111110000001
111011110000000111111110111111111011111101111000000000000111
111011110110110111111110111111111011111100000000000001111111
111000000010000000000110111111011011111110000000011001110001
100001111010000000110000111111011011000000000011001000000001
111111111011111110111110111100000000000000000000011011111111
111111100010000000111110111100000011111100000111111011111111
111110111000000000000000000000001111111111110111111011111111
100000000000111111111110000101111111111111110001111011110001
101111111110000000000011000001001111111000000110111001111101
111000000000111011111111010000001111000011101110110011111101
111111111110111010000111011111101111111111101110110000000001
110000001110000000000000000111100000000000001110110011101111
111101111111100000000000010100000000111110000010110011101111
111101111100000010001111110111100000000000000010110001101111
100001111011111011001111100000000000000111011000000000001111
110000000011111001001111111110000001110111011111110000000001
110111000000000000001111111111111100010111000011111111000001
110000000111000000000000000000000000010100000000000000000101
110110001111111000000001000110011110000111111111101111111001
110110111101111111111100001100000000000111111111100111111101
100110000001111111111100000000111111000111111111100000001101
111111111111111111111111111111111111111111111111111111111111
