111111111111111111111111111111111111111111111111111111111111
100000000000111000000000000100000000000000000000000000000001
100000000010011011010000000000011110111101111100000000000001
100000110000001011000000001111111110000000000001111111000111
100000000000001000000000000000000000111101000001111000000111
111100000001101000011000000000001110000101111111111011111111
100001111101100011111111111001111110100001111111111000000111
111111100000000000011111111100111110111101011111111111110111
1111111111111000010111E0111100111110111101000000000000000011
101111111111101001011110111100111110000001001111100111111001
100000000001101000000000111100110100110011001000000011111111
100000000001101111000000000100010000000011001111100011011111
111111101111101111011100000000000111110111000001110000011111
101111000001100000000000001100011100110111011101111111011111
101111001000000000000000001100011100110110000001000000011011
101111001111100111000000000000000100110110111100000001111011
101111001111100000000000111100110100110100000000000001111011
100000000000000000011110111000010100110110111111101100011011
100000000000000000000000111100000000110000000110000100000011
101111111111111111101110111100111111010110100110110100000011
101111111100000001101100011100111111010000100110110000000001
101111111111111100100000001100111111010110100110110010110001
100000000011111100101100001100011100000000000000000010111111
100011111111111000001111001100111101111000000000000110000111
100011111111111011111111000000000001111000000111111110000001
100000000000000000000011001011111110000001111111100000000001
110111111111110000011110001010010000000000000000000000101001
110111111111010000000000001011011111111011000000000111001001
110111111111000000111111001011011111111011011101111111000001
100111111111011000000000001000011111111000000001111110001111
111101111111010000000000001011000000001110111000000000000001
100000000000000001111000001000001110000010011011111111100001
111100001111100000011100000011000000011010011000000000100001
111100110111100001111101110011001111011000001111111101100001
111100000000101101111100000000001111011011101110000101000001
110101111110101101111111110000000111000000000000110100110111
110101110000101101110000000111110111011100000000000100110101
1101011100000001000001010101111100010D1101000000000001100001
110000000000000001110001000111111101000001111111000001111111
111111111111111111111111111111111111111111111111111111111111
